"end_lat","end_lng","number_of_members","number_of_casuals","number_of_electric","number_of_classic","number_of_docked","total"
0,0,6,2,1,7,0,8
41.55,-87.3,1,0,1,0,0,1
41.6,-87.61,0,1,1,0,0,1
41.62,-87.54,0,1,1,0,0,1
41.62,-87.53,0,1,1,0,0,1
41.63,-87.62,0,1,1,0,0,1
41.64,-87.7,1,1,2,0,0,2
41.64,-87.61,1,0,1,0,0,1
41.64,-87.54,1,0,1,0,0,1
41.6485007626641,-87.546089887619,18,72,35,55,0,90
41.648501,-87.54609,0,4,0,0,4,4
41.65,-87.62,1,11,12,0,0,12
41.65,-87.61,0,2,2,0,0,2
41.65,-87.6,0,9,9,0,0,9
41.65,-87.59,2,1,3,0,0,3
41.65,-87.56,0,2,2,0,0,2
41.65,-87.55,17,7,24,0,0,24
41.65,-87.54,7,3,9,1,0,10
41.65,-87.53,0,3,3,0,0,3
41.65,-87.52,0,2,2,0,0,2
41.6518678022852,-87.5396713614464,24,64,39,49,0,88
41.651868,-87.539671,0,13,0,0,13,13
41.6566655296737,-87.5988006591797,11,56,24,43,0,67
41.656666,-87.598801,0,8,0,0,8,8
41.658413,-87.610711,0,2,0,0,2,2
41.6584131511011,-87.6107108969882,6,61,18,49,0,67
41.65915,-87.550762,0,28,0,0,28,28
41.6591504275977,-87.550762295723,33,186,69,150,0,219
41.66,-87.69,0,1,1,0,0,1
41.66,-87.68,0,1,1,0,0,1
41.66,-87.66,0,1,1,0,0,1
41.66,-87.65,0,2,2,0,0,2
41.66,-87.64,11,3,14,0,0,14
41.66,-87.63,2,0,2,0,0,2
41.66,-87.62,0,1,1,0,0,1
41.66,-87.61,1,13,14,0,0,14
41.66,-87.6,2,17,19,0,0,19
41.66,-87.56,1,2,3,0,0,3
41.66,-87.55,5,39,44,0,0,44
41.66,-87.54,3,2,5,0,0,5
41.66,-87.53,0,1,1,0,0,1
41.666312,-87.557216,0,14,0,0,14,14
41.6663120082573,-87.5572156906128,4,61,20,45,0,65
41.668696,-87.637113,0,14,0,0,14,14
41.6686963533225,-87.6371133327484,19,73,29,63,0,92
41.67,-87.72,0,1,1,0,0,1
41.67,-87.69,0,2,2,0,0,2
41.67,-87.68,0,5,5,0,0,5
41.67,-87.66,2,2,4,0,0,4
41.67,-87.65,1,7,8,0,0,8
41.67,-87.64,34,8,42,0,0,42
41.67,-87.63,10,31,41,0,0,41
41.67,-87.62,0,11,11,0,0,11
41.67,-87.56,0,2,2,0,0,2
41.67,-87.55,1,0,1,0,0,1
41.67,-87.54,0,2,2,0,0,2
41.67,-87.52,0,1,1,0,0,1
41.67,-87.51,0,2,2,0,0,2
41.6706438368798,-87.6225864887238,4,75,38,41,0,79
41.670644,-87.622586,0,4,0,0,4,4
41.68,-87.74,10,1,11,0,0,11
41.68,-87.72,0,1,1,0,0,1
41.68,-87.71,1,3,4,0,0,4
41.68,-87.7,5,4,9,0,0,9
41.68,-87.69,0,2,2,0,0,2
41.68,-87.68,9,35,44,0,0,44
41.68,-87.67,2,8,10,0,0,10
41.68,-87.66,27,22,49,0,0,49
41.68,-87.65,6,34,40,0,0,40
41.68,-87.64,73,24,97,0,0,97
41.68,-87.63,1,43,44,0,0,44
41.68,-87.62,3,29,32,0,0,32
41.68,-87.61,1,0,1,0,0,1
41.68,-87.58,0,1,1,0,0,1
41.68,-87.54,2,20,22,0,0,22
41.681001,-87.537931,0,5,0,0,5,5
41.6810014591104,-87.5379312226869,44,92,37,99,0,136
41.684595,-87.670708,0,10,0,0,10,10
41.6845950720262,-87.6707080006599,141,78,136,83,0,219
41.684931595193,-87.6452887058258,55,123,108,70,0,178
41.684932,-87.645289,0,5,0,0,5,5
41.685877,-87.573824,0,70,0,0,70,70
41.6858770556233,-87.573823928833,53,124,60,117,0,177
41.6870147946712,-87.6210522651672,16,60,23,53,0,76
41.687015,-87.621052,0,6,0,0,6,6
41.6875616233574,-87.6554757356644,25,42,47,20,0,67
41.687562,-87.655476,0,7,0,0,7,7
41.69,-87.77,1,0,1,0,0,1
41.69,-87.74,1,2,3,0,0,3
41.69,-87.72,0,13,13,0,0,13
41.69,-87.71,0,43,43,0,0,43
41.69,-87.7,14,33,47,0,0,47
41.69,-87.69,24,40,64,0,0,64
41.69,-87.68,59,89,148,0,0,148
41.69,-87.67,180,69,249,0,0,249
41.69,-87.66,4,17,21,0,0,21
41.69,-87.65,226,84,310,0,0,310
41.69,-87.64,46,52,98,0,0,98
41.69,-87.63,32,27,59,0,0,59
41.69,-87.62,18,24,42,0,0,42
41.69,-87.61,319,83,402,0,0,402
41.69,-87.6,9,10,19,0,0,19
41.69,-87.57,1,4,5,0,0,5
41.69,-87.56,1,5,6,0,0,6
41.69,-87.54,2,51,53,0,0,53
41.69,-87.53,8,24,32,0,0,32
41.69,-87.52,1,12,13,0,0,13
41.69,-87.51,0,2,2,0,0,2
41.691211,-87.681297,0,22,0,0,22,22
41.691211034981,-87.6812973618507,102,190,124,168,0,292
41.691319,-87.712886,0,28,0,0,28,28
41.6913191922107,-87.7128857374191,26,127,55,98,0,153
41.6917097584701,-87.6100015640259,99,73,54,118,0,172
41.69171,-87.610002,0,9,0,0,9,9
41.6917738511683,-87.5304311513901,120,312,84,348,0,432
41.691774,-87.530431,0,90,0,0,90,90
41.6922625558917,-87.6426118612289,63,67,85,45,0,130
41.692263,-87.642612,0,3,0,0,3,3
41.6923947458756,-87.7009606361389,51,76,41,86,0,127
41.692395,-87.700961,0,12,0,0,12,12
41.69501,-87.598715,0,6,0,0,6,6
41.6950104493814,-87.5987148284912,25,106,84,47,0,131
41.699206,-87.668919,0,40,0,0,40,40
41.6992061681277,-87.668918967247,72,148,141,79,0,220
41.7,-87.76,0,1,1,0,0,1
41.7,-87.74,0,2,2,0,0,2
41.7,-87.73,0,4,4,0,0,4
41.7,-87.72,1,7,8,0,0,8
41.7,-87.71,0,18,18,0,0,18
41.7,-87.7,4,58,61,1,0,62
41.7,-87.69,11,32,43,0,0,43
41.7,-87.68,35,104,139,0,0,139
41.7,-87.67,17,37,54,0,0,54
41.7,-87.66,136,15,151,0,0,151
41.7,-87.65,41,36,77,0,0,77
41.7,-87.64,27,24,51,0,0,51
41.7,-87.63,25,30,55,0,0,55
41.7,-87.62,6,43,49,0,0,49
41.7,-87.61,12,35,47,0,0,47
41.7,-87.6,83,82,165,0,0,165
41.7,-87.59,8,11,19,0,0,19
41.7,-87.57,1,0,1,0,0,1
41.7,-87.56,1,23,24,0,0,24
41.7,-87.54,18,51,69,0,0,69
41.7,-87.53,12,51,63,0,0,63
41.7,-87.52,6,4,10,0,0,10
41.700121,-87.61226,0,21,0,0,21,21
41.7001213792389,-87.6122599840164,20,91,46,65,0,111
41.7028008502259,-87.5597262382507,38,108,68,78,0,146
41.702801,-87.559726,0,4,0,0,4,4
41.704575,-87.528232,0,30,0,0,30,30
41.7045750872071,-87.5282317399979,39,184,57,166,0,223
41.704587,-87.681203,0,13,0,0,13,13
41.7045871021891,-87.6812034845352,91,148,100,139,0,239
41.7046131666667,-87.5284511666667,0,1,1,0,0,1
41.7046293333333,-87.6811565,0,1,1,0,0,1
41.7049255649976,-87.6568681095887,67,51,68,50,0,118
41.704926,-87.656868,0,6,0,0,6,6
41.7051397889324,-87.6424241065979,75,53,88,40,0,128
41.70514,-87.642424,0,1,0,0,1,1
41.7053079969982,-87.6292169094086,11,19,7,23,0,30
41.705308,-87.629217,0,7,0,0,7,7
41.70717,-87.618472,0,4,0,0,4,4
41.7071702711776,-87.6184719800949,36,118,90,64,0,154
41.70725,-87.607663,0,18,0,0,18,18
41.7072503677818,-87.6076626777649,55,105,73,87,0,160
41.709581,-87.590234,0,1,0,0,1,1
41.7095811352626,-87.5902336835861,120,11,101,30,0,131
41.71,-87.74,0,2,2,0,0,2
41.71,-87.72,22,163,185,0,0,185
41.71,-87.71,0,10,10,0,0,10
41.71,-87.7,9,39,48,0,0,48
41.71,-87.69,15,47,62,0,0,62
41.71,-87.68,20,79,99,0,0,99
41.71,-87.67,129,218,347,0,0,347
41.71,-87.66,5,40,45,0,0,45
41.71,-87.65,5,26,31,0,0,31
41.71,-87.64,21,46,67,0,0,67
41.71,-87.63,6,38,44,0,0,44
41.71,-87.62,13,30,43,0,0,43
41.71,-87.61,32,27,59,0,0,59
41.71,-87.6,166,146,311,1,0,312
41.71,-87.59,35,20,55,0,0,55
41.71,-87.58,4,5,9,0,0,9
41.71,-87.57,9,18,27,0,0,27
41.71,-87.56,6,12,18,0,0,18
41.71,-87.55,8,2,10,0,0,10
41.71,-87.54,5,19,24,0,0,24
41.71,-87.53,4,8,12,0,0,12
41.712164,-87.667733,0,16,0,0,16,16
41.712164103598,-87.6677334308624,79,218,176,121,0,297
41.712748761095,-87.5348138809204,54,71,31,94,0,125
41.712749,-87.534814,0,11,0,0,11,11
41.713317,-87.551098,0,12,0,0,12,12
41.713317395477,-87.5510975718498,18,26,8,36,0,44
41.713397,-87.565842,0,3,0,0,3,3
41.7133974844225,-87.5658416748047,63,50,34,79,0,113
41.7137098303562,-87.5308442115784,76,113,48,141,0,189
41.71371,-87.530844,0,102,0,0,102,102
41.717878,-87.564592,0,13,0,0,13,13
41.717878301935,-87.5645917654037,9,34,11,32,0,43
41.718703,-87.597036,0,3,0,0,3,3
41.7187031547574,-87.5970357656479,156,67,169,54,0,223
41.718963,-87.608296,0,9,0,0,9,9
41.7189634216545,-87.6082956790924,393,129,338,184,0,522
41.719712,-87.64302,0,15,0,0,15,15
41.7197121836188,-87.6430195569992,227,95,157,165,0,322
41.72,-87.78,0,1,1,0,0,1
41.72,-87.74,0,2,2,0,0,2
41.72,-87.73,1,1,2,0,0,2
41.72,-87.72,0,3,3,0,0,3
41.72,-87.7,0,3,3,0,0,3
41.72,-87.69,6,6,12,0,0,12
41.72,-87.68,77,167,244,0,0,244
41.72,-87.67,30,33,63,0,0,63
41.72,-87.66,49,61,110,0,0,110
41.72,-87.65,69,33,102,0,0,102
41.72,-87.64,40,27,67,0,0,67
41.72,-87.63,40,13,53,0,0,53
41.72,-87.62,105,161,266,0,0,266
41.72,-87.61,120,25,145,0,0,145
41.72,-87.6,60,49,109,0,0,109
41.72,-87.59,3,3,6,0,0,6
41.72,-87.58,19,17,36,0,0,36
41.72,-87.57,18,11,29,0,0,29
41.72,-87.56,1,8,9,0,0,9
41.72,-87.55,1,1,2,0,0,2
41.72,-87.54,9,33,42,0,0,42
41.72,-87.53,4,8,12,0,0,12
41.72,-87.52,0,1,1,0,0,1
41.721696,-87.622278,0,1,1,0,0,1
41.7218499,-87.6228544,361,386,444,303,0,747
41.72185,-87.622854,0,14,0,0,14,14
41.7222907409526,-87.5789684057236,53,60,36,77,0,113
41.722291,-87.578968,0,14,0,0,14,14
41.726166,-87.566276,0,4,0,0,4,4
41.7261663902451,-87.5662761926651,34,36,20,50,0,70
41.7267989637012,-87.6542901992798,166,84,127,123,0,250
41.726799,-87.65429,0,13,0,0,13,13
41.7275756592996,-87.6348280906677,11,74,48,37,0,85
41.727576,-87.634828,0,4,0,0,4,4
41.728204,-87.5497,0,14,0,0,14,14
41.728204215358,-87.5497001409531,60,111,64,107,0,171
41.7282338,-87.6675239,63,141,100,104,0,204
41.728234,-87.667524,0,27,0,0,27,27
41.728264,-87.597299,0,3,0,0,3,3
41.7282642681627,-87.5972986221313,42,93,73,62,0,135
41.729285,-87.611032,0,5,0,0,5,5
41.7292851572549,-87.6110315322876,46,65,36,75,0,111
41.73,-87.72,0,1,1,0,0,1
41.73,-87.68,13,53,66,0,0,66
41.73,-87.67,15,26,41,0,0,41
41.73,-87.66,12,27,39,0,0,39
41.73,-87.65,76,9,85,0,0,85
41.73,-87.64,4,30,34,0,0,34
41.73,-87.63,6,11,17,0,0,17
41.73,-87.62,21,10,31,0,0,31
41.73,-87.61,19,34,53,0,0,53
41.73,-87.6,7,48,55,0,0,55
41.73,-87.59,3,31,34,0,0,34
41.73,-87.58,2,21,23,0,0,23
41.73,-87.57,2,7,9,0,0,9
41.73,-87.56,18,15,33,0,0,33
41.73,-87.55,101,48,149,0,0,149
41.73,-87.54,2,12,14,0,0,14
41.7313949433024,-87.5857436656952,41,123,72,92,0,164
41.731395,-87.585744,0,15,0,0,15,15
41.7323797532955,-87.6580694317818,44,109,95,58,0,153
41.73238,-87.658069,0,3,0,0,3,3
41.7336687907147,-87.558342218399,44,102,42,104,0,146
41.733669,-87.558342,0,12,0,0,12,12
41.736218766794,-87.6226454973221,77,46,70,53,0,123
41.736219,-87.622645,0,1,0,0,1,1
41.7365530183196,-87.6226441562176,84,38,76,46,0,122
41.736559,-87.601258,0,8,0,0,8,8
41.7365590228221,-87.6012575626373,70,93,51,112,0,163
41.736646,-87.622634,89,126,118,90,7,215
41.736815,-87.582801,0,8,0,0,8,8
41.7368152144067,-87.5828012824059,72,78,60,90,0,150
41.737151,-87.57274,0,17,0,0,17,17
41.7371514643106,-87.572740316391,38,77,41,74,0,115
41.7373356004167,-87.5485146045685,65,123,85,103,0,188
41.737336,-87.548515,0,11,0,0,11,11
41.737848,-87.6449,0,2,0,0,2,2
41.7378484767334,-87.6448997855186,119,53,67,105,0,172
41.74,-87.74,0,3,3,0,0,3
41.74,-87.73,0,1,1,0,0,1
41.74,-87.72,1,1,2,0,0,2
41.74,-87.71,0,2,2,0,0,2
41.74,-87.7,0,1,1,0,0,1
41.74,-87.69,1,2,3,0,0,3
41.74,-87.68,43,15,58,0,0,58
41.74,-87.67,1,20,21,0,0,21
41.74,-87.66,167,39,206,0,0,206
41.74,-87.65,30,36,66,0,0,66
41.74,-87.64,7,4,11,0,0,11
41.74,-87.63,62,56,118,0,0,118
41.74,-87.62,29,29,58,0,0,58
41.74,-87.61,39,28,67,0,0,67
41.74,-87.6,47,56,103,0,0,103
41.74,-87.59,20,59,79,0,0,79
41.74,-87.58,21,39,60,0,0,60
41.74,-87.57,4,36,40,0,0,40
41.74,-87.56,39,28,67,0,0,67
41.74,-87.55,181,32,213,0,0,213
41.74,-87.54,4,5,9,0,0,9
41.74,-87.53,13,51,64,0,0,64
41.7414865286181,-87.6584100723267,70,63,47,86,0,133
41.741487,-87.65841,0,7,0,0,7,7
41.743116,-87.6148,98,75,42,110,21,173
41.743316,-87.622849,16,16,11,18,3,32
41.7433597622532,-87.6228439807892,3,9,3,9,0,12
41.74336,-87.622844,0,1,0,0,1,1
41.743432283,-87.604870319,0,1,1,0,0,1
41.743441,-87.604836,264,217,250,217,14,481
41.743717,-87.634088,85,93,76,93,9,178
41.7437193333333,-87.6341123333333,0,1,1,0,0,1
41.743844,-87.622769,0,7,0,0,7,7
41.7438440723149,-87.6227688789368,5,6,0,11,0,11
41.743921,-87.575225,19,66,34,49,2,85
41.744123,-87.599034,53,140,108,74,11,193
41.744531,-87.56506,60,78,35,92,11,138
41.744615,-87.551208,98,137,124,99,12,235
41.746559,-87.586005,170,57,81,137,9,227
41.747363,-87.580046,5,25,22,7,1,30
41.75,-87.77,0,1,1,0,0,1
41.75,-87.76,0,1,1,0,0,1
41.75,-87.74,3,5,8,0,0,8
41.75,-87.73,1,2,3,0,0,3
41.75,-87.72,0,7,7,0,0,7
41.75,-87.71,1,0,1,0,0,1
41.75,-87.7,3,6,9,0,0,9
41.75,-87.69,0,1,1,0,0,1
41.75,-87.68,78,42,120,0,0,120
41.75,-87.67,14,31,45,0,0,45
41.75,-87.66,4,62,66,0,0,66
41.75,-87.65,11,19,29,1,0,30
41.75,-87.64,15,18,33,0,0,33
41.75,-87.63,19,24,43,0,0,43
41.75,-87.62,8,19,27,0,0,27
41.75,-87.61,96,46,142,0,0,142
41.75,-87.6,31,84,115,0,0,115
41.75,-87.59,17,19,36,0,0,36
41.75,-87.58,5,30,35,0,0,35
41.75,-87.57,24,36,60,0,0,60
41.75,-87.56,20,68,88,0,0,88
41.75,-87.55,14,21,35,0,0,35
41.75,-87.54,2,0,2,0,0,2
41.750794,-87.624424,244,277,202,293,26,521
41.75094,-87.61379,49,173,69,121,32,222
41.751173,-87.585337,66,69,30,94,11,135
41.751294,-87.597552,39,89,60,62,6,128
41.751731,-87.552812,144,106,50,183,17,250
41.751785,-87.578496,36,80,47,61,8,116
41.75182,-87.565211,154,193,91,240,16,347
41.7518388333333,-87.5652893333333,0,1,1,0,0,1
41.7522048494112,-87.663699388504,28,71,34,65,0,99
41.752205,-87.663699,0,9,0,0,9,9
41.752487,-87.643902,0,12,0,0,12,12
41.7524870124901,-87.6439021574879,60,131,109,82,0,191
41.753174,-87.605026,131,66,106,86,5,197
41.756971,-87.624621,27,41,25,42,1,68
41.75712,-87.575839,0,25,0,0,25,25
41.75712006802,-87.5758393587,93,110,82,121,0,203
41.757871,-87.549386,0,42,0,0,42,42
41.75787144829,-87.54938625,94,108,66,136,0,202
41.75797,-87.63121,17,81,25,68,5,98
41.758361,-87.614138,47,143,80,93,17,190
41.75849,-87.60641,144,72,133,75,8,216
41.7586696704,-87.586882871,194,168,139,223,0,362
41.75867,-87.586883,0,38,0,0,38,38
41.758768,-87.56644,127,189,132,163,21,316
41.75916,-87.595751,25,46,24,45,2,71
41.759236,-87.663474,0,12,0,0,12,12
41.7592360242587,-87.6634740829468,31,70,32,69,0,101
41.759274,-87.673634,0,3,0,0,3,3
41.7592740393312,-87.6736342906952,22,41,26,37,0,63
41.76,-87.8,0,1,1,0,0,1
41.76,-87.79,0,5,5,0,0,5
41.76,-87.74,0,3,3,0,0,3
41.76,-87.73,0,1,1,0,0,1
41.76,-87.72,4,9,13,0,0,13
41.76,-87.71,0,4,4,0,0,4
41.76,-87.7,0,4,4,0,0,4
41.76,-87.69,3,12,15,0,0,15
41.76,-87.68,24,34,58,0,0,58
41.76,-87.67,2,22,24,0,0,24
41.76,-87.66,39,34,72,1,0,73
41.76,-87.65,57,41,98,0,0,98
41.76,-87.64,39,25,64,0,0,64
41.76,-87.63,1,16,17,0,0,17
41.76,-87.62,11,18,29,0,0,29
41.76,-87.61,17,39,56,0,0,56
41.76,-87.6,12,19,31,0,0,31
41.76,-87.59,21,32,53,0,0,53
41.76,-87.58,27,58,85,0,0,85
41.76,-87.57,97,56,153,0,0,153
41.76,-87.56,53,86,139,0,0,139
41.76,-87.55,24,20,44,0,0,44
41.761605,-87.644161,0,4,0,0,4,4
41.7616054380439,-87.6441609766607,103,70,106,67,0,173
41.76218896038,-87.55927465,326,215,226,315,0,541
41.762189,-87.559275,0,34,0,0,34,34
41.765286,-87.621748,20,130,60,85,5,150
41.765508,-87.616918,0,8,0,0,8,8
41.76550800581,-87.616917925,28,35,27,36,0,63
41.765719,-87.60496,0,11,0,0,11,11
41.76571903697,-87.604959713,109,138,88,159,0,247
41.766,-87.611726,17,44,29,29,3,61
41.766409,-87.565688,0,79,0,0,79,79
41.7664094567,-87.5656875719,965,591,629,927,0,1556
41.7664703333333,-87.586487,0,1,1,0,0,1
41.7664929373,-87.5864608775,140,260,162,238,0,400
41.766493,-87.586461,0,18,0,0,18,18
41.766501665,-87.586420417,0,1,1,0,0,1
41.766638,-87.57645,0,38,0,0,38,38
41.76663823695,-87.5764501141,300,293,227,366,0,593
41.768898,-87.635876,54,118,53,116,3,172
41.768938,-87.652934,257,77,179,151,4,334
41.76906172032,-87.6446135779,54,59,38,75,0,113
41.769062,-87.644614,0,8,0,0,8,8
41.769293,-87.628196,0,11,0,0,11,11
41.76929308995,-87.6281959291,97,292,189,200,0,389
41.77,-87.8,0,1,1,0,0,1
41.77,-87.79,0,1,1,0,0,1
41.77,-87.76,0,1,1,0,0,1
41.77,-87.74,4,9,13,0,0,13
41.77,-87.73,43,185,228,0,0,228
41.77,-87.72,38,105,143,0,0,143
41.77,-87.71,7,34,41,0,0,41
41.77,-87.7,50,61,111,0,0,111
41.77,-87.69,65,231,296,0,0,296
41.77,-87.68,6,14,20,0,0,20
41.77,-87.67,8,10,18,0,0,18
41.77,-87.66,22,34,56,0,0,56
41.77,-87.65,74,36,110,0,0,110
41.77,-87.64,32,90,122,0,0,122
41.77,-87.63,21,56,77,0,0,77
41.77,-87.62,10,38,48,0,0,48
41.77,-87.61,18,116,134,0,0,134
41.77,-87.6,12,42,53,1,0,54
41.77,-87.59,97,155,252,0,0,252
41.77,-87.58,125,89,214,0,0,214
41.77,-87.57,200,113,313,0,0,313
41.77,-87.56,39,38,77,0,0,77
41.77,-87.55,1,0,1,0,0,1
41.773458,-87.58534,0,29,0,0,29,29
41.77345849948,-87.5853397391,140,309,158,291,0,449
41.77351755125,-87.5771428255,181,330,235,276,0,511
41.773518,-87.577143,0,70,0,0,70,70
41.773643,-87.567514,712,552,385,770,109,1264
41.77366221,-87.567373395,0,1,1,0,0,1
41.77372095205,-87.60563486,219,189,181,227,0,408
41.773721,-87.605635,0,15,0,0,15,15
41.774074,-87.663815,47,27,35,35,4,74
41.775393,-87.654308,11,60,34,32,5,71
41.778881,-87.586647,163,305,164,241,63,468
41.779374,-87.664843,89,104,97,87,9,193
41.779381,-87.644621,0,21,0,0,21,21
41.77938114228,-87.6446208145,151,172,166,157,0,323
41.779835,-87.634774,61,134,71,121,3,195
41.77987,-87.650919,11,42,17,36,0,53
41.78,-87.78,3,1,4,0,0,4
41.78,-87.77,0,2,2,0,0,2
41.78,-87.76,0,2,2,0,0,2
41.78,-87.74,10,26,36,0,0,36
41.78,-87.73,106,250,356,0,0,356
41.78,-87.72,196,353,549,0,0,549
41.78,-87.71,174,392,566,0,0,566
41.78,-87.7,155,369,524,0,0,524
41.78,-87.69,81,112,193,0,0,193
41.78,-87.68,40,95,135,0,0,135
41.78,-87.67,48,18,66,0,0,66
41.78,-87.66,11,27,38,0,0,38
41.78,-87.65,19,28,47,0,0,47
41.78,-87.64,36,65,101,0,0,101
41.78,-87.63,18,33,51,0,0,51
41.78,-87.62,55,57,112,0,0,112
41.78,-87.61,457,219,675,1,0,676
41.78,-87.6,1317,446,1763,0,0,1763
41.78,-87.59,219,188,398,9,0,407
41.78,-87.58,42,81,123,0,0,123
41.78,-87.57,95,128,223,0,0,223
41.78007963264,-87.6297463052,161,259,236,184,0,420
41.78008,-87.629746,0,9,0,0,9,9
41.78008063659,-87.6159428567,234,246,253,227,0,480
41.780081,-87.615943,0,18,0,0,18,18
41.7804056457,-87.5914159893,415,494,357,552,0,909
41.780406,-87.591416,0,59,0,0,59,59
41.7804796666667,-87.5913633333333,0,1,1,0,0,1
41.7805309407088,-87.6059702038765,530,301,334,497,0,831
41.780531,-87.60597,0,17,0,0,17,17
41.780595,-87.584846,90,113,59,130,14,203
41.7806009452142,-87.6058360934258,370,300,310,360,0,670
41.780601,-87.605836,0,31,0,0,31,31
41.780910964248,-87.5763237476349,397,421,186,632,0,818
41.780911,-87.576324,0,109,0,0,109,109
41.783189,-87.654372,10,69,38,30,11,79
41.784071,-87.614484,0,27,0,0,27,27
41.784071072761,-87.6144835352898,246,266,251,261,0,512
41.78414169317,-87.6133078304,35,48,55,28,0,83
41.784142,-87.613308,0,1,0,0,1,1
41.785024524,-87.601127505,1,0,1,0,0,1
41.7850961666667,-87.6011535,0,1,1,0,0,1
41.785097,-87.601073,0,247,0,0,247,247
41.78509714636,-87.6010727606,23955,5195,6963,22187,0,29150
41.7851865,-87.6010415,1,0,1,0,0,1
41.785861,-87.674144,0,14,0,0,14,14
41.785861065132,-87.674143910408,31,240,150,121,0,271
41.786833,-87.666215,19,48,38,26,3,67
41.787539,-87.644874,33,58,24,64,3,91
41.7879341666667,-87.5888393333333,0,1,1,0,0,1
41.78794281287,-87.5883151702,5445,1042,1688,4799,0,6487
41.787943,-87.588315,0,82,0,0,82,82
41.788707376,-87.601280451,0,1,1,0,0,1
41.788746,-87.601334,9904,2277,2607,9462,112,12181
41.7887508333333,-87.6014151666667,0,1,1,0,0,1
41.7887543333333,-87.601375,0,1,1,0,0,1
41.7896968804834,-87.65469789505,99,35,98,36,0,134
41.789697,-87.654698,0,3,0,0,3,3
41.79,-87.8,0,6,6,0,0,6
41.79,-87.79,0,2,2,0,0,2
41.79,-87.77,0,4,4,0,0,4
41.79,-87.75,0,1,1,0,0,1
41.79,-87.74,81,288,369,0,0,369
41.79,-87.73,67,135,202,0,0,202
41.79,-87.72,112,318,430,0,0,430
41.79,-87.71,131,546,677,0,0,677
41.79,-87.7,299,715,1014,0,0,1014
41.79,-87.69,106,542,647,1,0,648
41.79,-87.68,14,45,59,0,0,59
41.79,-87.67,2,26,28,0,0,28
41.79,-87.66,22,39,61,0,0,61
41.79,-87.65,71,26,97,0,0,97
41.79,-87.64,3,7,10,0,0,10
41.79,-87.63,74,52,126,0,0,126
41.79,-87.62,108,134,242,0,0,242
41.79,-87.61,166,55,220,1,0,221
41.79,-87.6,6908,1779,8683,4,0,8687
41.79,-87.59,1786,650,2432,4,0,2436
41.79,-87.58,304,215,519,0,0,519
41.791478,-87.599861,25478,6388,7960,23616,290,31866
41.791483402,-87.599937201,1,0,1,0,0,1
41.7914868333333,-87.599992,1,0,1,0,0,1
41.7915408333333,-87.6078356666667,1,0,1,0,0,1
41.791568,-87.607852,0,45,0,0,45,45
41.79156801058,-87.6078521774,785,333,341,777,0,1118
41.791728,-87.583945,0,625,0,0,625,625
41.79172820953,-87.583945009,1801,2368,1405,2764,0,4169
41.792822,-87.664429,35,118,95,50,8,153
41.79292964599,-87.6449900565,54,62,49,67,0,116
41.79293,-87.64499,0,8,0,0,8,8
41.793242,-87.587782,6467,2527,2189,6635,170,8994
41.793429,-87.615853,0,22,0,0,22,22
41.79342945658,-87.6158532619,115,187,113,189,0,302
41.7934668333333,-87.6158608333333,0,1,1,0,0,1
41.794087,-87.675478,17,146,45,104,14,163
41.794228,-87.655073,85,160,97,134,14,245
41.79430062054,-87.6014497734,19060,4102,5691,17471,0,23162
41.794301,-87.60145,0,145,0,0,145,145
41.7943128333333,-87.6014948333333,1,0,1,0,0,1
41.794318557,-87.60145545,0,1,1,0,0,1
41.7943358333333,-87.6012665,0,1,1,0,0,1
41.794853,-87.618691,891,660,611,865,75,1551
41.794982,-87.633124,230,199,193,225,11,429
41.795212,-87.580715,7619,5143,3543,8562,657,12762
41.795264,-87.596471,7215,2677,2813,6917,162,9892
41.7952898333333,-87.5964885,1,0,1,0,0,1
41.796642,-87.625923,109,74,60,107,16,183
41.799336,-87.600958,0,122,0,0,122,122
41.79933626261,-87.6009581145,5390,1196,1633,4953,0,6586
41.799341,-87.5947003333333,0,1,1,0,0,1
41.799494,-87.58645,0,313,0,0,313,313
41.79949429373,-87.5864498959,5103,2865,2665,5303,0,7968
41.7995435,-87.5948121666667,1,0,1,0,0,1
41.799568,-87.594747,13215,5306,5753,12484,284,18521
41.7996006666667,-87.5948331666667,0,1,1,0,0,1
41.799659,-87.657195,55,70,82,33,10,125
41.7996783333333,-87.6571536666667,0,1,1,0,0,1
41.8,-87.8,1,0,1,0,0,1
41.8,-87.78,0,1,1,0,0,1
41.8,-87.77,1,4,5,0,0,5
41.8,-87.76,11,13,24,0,0,24
41.8,-87.75,119,286,405,0,0,405
41.8,-87.74,24,51,75,0,0,75
41.8,-87.73,45,192,237,0,0,237
41.8,-87.72,628,651,1279,0,0,1279
41.8,-87.71,44,165,209,0,0,209
41.8,-87.7,670,1034,1703,1,0,1704
41.8,-87.69,159,201,360,0,0,360
41.8,-87.68,128,282,410,0,0,410
41.8,-87.67,17,130,147,0,0,147
41.8,-87.66,39,77,116,0,0,116
41.8,-87.65,35,40,75,0,0,75
41.8,-87.64,10,2,12,0,0,12
41.8,-87.63,7,18,25,0,0,25
41.8,-87.62,203,117,320,0,0,320
41.8,-87.61,120,92,212,0,0,212
41.8,-87.6,2080,764,2842,2,0,2844
41.8,-87.59,3345,1358,4697,6,0,4703
41.8,-87.58,992,637,1629,0,0,1629
41.8,-87.57,1,0,1,0,0,1
41.800908,-87.674684,44,116,91,60,9,160
41.80183164049,-87.645213904,230,145,101,274,0,375
41.801832,-87.645214,0,11,0,0,11,11
41.80229465088,-87.6180535802,653,400,510,543,0,1053
41.802295,-87.618054,0,24,0,0,24,24
41.802406,-87.586924,5404,3077,2455,5627,399,8481
41.802562,-87.590368,3447,1699,1687,3320,139,5146
41.802888155,-87.596238017,0,1,1,0,0,1
41.803023,-87.664699,122,109,147,76,8,231
41.803038,-87.606615,927,757,679,940,65,1684
41.805661,-87.683392,124,277,183,193,25,401
41.805772,-87.592464,759,420,544,583,52,1179
41.80813391481,-87.6456165545,342,174,251,265,0,516
41.808134,-87.645617,0,14,0,0,14,14
41.808227,-87.67718,136,268,157,230,17,404
41.80839,-87.656526,50,63,43,60,10,113
41.80887,-87.66454,363,180,236,278,29,543
41.80931770924,-87.633449288,436,311,386,361,0,747
41.809318,-87.633449,0,10,0,0,10,10
41.809443,-87.591875,1704,1148,996,1640,216,2852
41.809835,-87.599383,1608,889,1158,1250,89,2497
41.809851,-87.616279,253,365,203,359,56,618
41.809855,-87.606755,1108,685,716,1011,66,1793
41.8098838333333,-87.6067236666667,0,1,1,0,0,1
41.81,-87.75,5,126,131,0,0,131
41.81,-87.74,21,19,40,0,0,40
41.81,-87.73,103,195,298,0,0,298
41.81,-87.72,287,222,509,0,0,509
41.81,-87.71,243,123,366,0,0,366
41.81,-87.7,160,540,700,0,0,700
41.81,-87.69,120,215,335,0,0,335
41.81,-87.68,150,119,269,0,0,269
41.81,-87.67,143,126,269,0,0,269
41.81,-87.66,75,72,147,0,0,147
41.81,-87.65,30,21,51,0,0,51
41.81,-87.64,16,67,83,0,0,83
41.81,-87.63,42,52,94,0,0,94
41.81,-87.62,264,163,427,0,0,427
41.81,-87.61,213,192,405,0,0,405
41.81,-87.6,476,163,639,0,0,639
41.81,-87.59,308,157,465,0,0,465
41.81,-87.58,8,12,20,0,0,20
41.813996,-87.666589,288,179,283,171,13,467
41.8140731666667,-87.59701,1,0,1,0,0,1
41.8140835,-87.5970271666667,1,0,1,0,0,1
41.81409271048,-87.5970051479,1040,501,585,956,0,1541
41.814093,-87.597005,0,92,0,0,92,92
41.81620767856,-87.6348193497,120,183,170,133,0,303
41.816208,-87.634819,0,5,0,0,5,5
41.816499,-87.606582,1068,510,779,740,59,1578
41.81665889302,-87.6194124619,585,483,615,453,0,1068
41.816659,-87.619412,0,34,0,0,34,34
41.819102,-87.643278,250,224,274,179,21,474
41.82,-87.86,0,1,1,0,0,1
41.82,-87.83,0,1,1,0,0,1
41.82,-87.76,0,1,1,0,0,1
41.82,-87.74,0,1,1,0,0,1
41.82,-87.73,66,6,72,0,0,72
41.82,-87.72,111,123,234,0,0,234
41.82,-87.71,34,31,65,0,0,65
41.82,-87.7,341,493,834,0,0,834
41.82,-87.69,374,557,931,0,0,931
41.82,-87.68,17,81,98,0,0,98
41.82,-87.67,26,30,56,0,0,56
41.82,-87.66,4,3,7,0,0,7
41.82,-87.65,20,40,60,0,0,60
41.82,-87.64,41,25,66,0,0,66
41.82,-87.63,129,65,194,0,0,194
41.82,-87.62,132,205,337,0,0,337
41.82,-87.61,70,100,168,2,0,170
41.82,-87.6,282,285,567,0,0,567
41.82,-87.59,45,26,71,0,0,71
41.82168,-87.6216,117,271,186,171,31,388
41.822720289,-87.61543107,0,1,1,0,0,1
41.822985,-87.6071,465,783,418,658,172,1248
41.823015,-87.626568,0,5,0,0,5,5
41.82301523798,-87.6265680185,170,80,173,77,0,250
41.823192,-87.676597,288,232,264,207,49,520
41.823465,-87.665577,150,114,94,158,12,264
41.823613,-87.650931,153,72,75,149,1,225
41.824232875584,-87.5981622934341,0,3,2,1,0,3
41.8244647320363,-87.5981448590755,3,9,5,7,0,12
41.824465,-87.598145,0,3,0,0,3,3
41.8246,-87.61678,760,671,643,706,82,1431
41.826712,-87.683144,361,259,248,299,73,620
41.827059,-87.64572,381,284,301,348,16,665
41.8287303333333,-87.6806566666667,0,1,1,0,0,1
41.828792,-87.680604,0,64,0,0,64,64
41.82879201994,-87.6806044594,655,565,826,394,0,1220
41.83,-87.79,1,1,2,0,0,2
41.83,-87.77,1,1,2,0,0,2
41.83,-87.76,0,2,2,0,0,2
41.83,-87.75,1,4,5,0,0,5
41.83,-87.74,0,2,2,0,0,2
41.83,-87.73,40,36,76,0,0,76
41.83,-87.72,51,43,94,0,0,94
41.83,-87.71,8,8,16,0,0,16
41.83,-87.7,11,15,26,0,0,26
41.83,-87.69,29,125,154,0,0,154
41.83,-87.68,261,241,502,0,0,502
41.83,-87.67,176,133,309,0,0,309
41.83,-87.66,82,76,158,0,0,158
41.83,-87.65,379,204,583,0,0,583
41.83,-87.64,119,99,218,0,0,218
41.83,-87.63,747,250,996,1,0,997
41.83,-87.62,358,197,555,0,0,555
41.83,-87.61,469,373,842,0,0,842
41.83,-87.6,68,86,154,0,0,154
41.83010465416,-87.6702983089,686,422,677,431,0,1108
41.830105,-87.670298,0,35,0,0,35,35
41.830661,-87.647172,2080,1046,1444,1583,99,3126
41.830688564721,-87.6562106609344,1048,441,748,741,0,1489
41.830689,-87.656211,0,52,0,0,52,52
41.830707,-87.641255,0,40,0,0,40,40
41.8307070514409,-87.6412553340197,1407,558,835,1130,0,1965
41.830770016,-87.656295061,1,0,1,0,0,1
41.830777,-87.632504,1190,880,893,1077,100,2070
41.831014,-87.641184,0,6,0,0,6,6
41.8310143299212,-87.6411835849285,76,11,29,58,0,87
41.831036,-87.626798,0,110,0,0,110,110
41.8310363140161,-87.6267975568771,5053,938,2251,3740,0,5991
41.831274,-87.608799,0,348,0,0,348,348
41.83127423549,-87.6087991946,1469,1028,867,1630,0,2497
41.8312996666667,-87.6087005,0,1,1,0,0,1
41.831379,-87.618034,2388,607,993,1943,59,2995
41.83452988563,-87.6318229814,2821,774,1222,2373,0,3595
41.83453,-87.631823,0,61,0,0,61,61
41.834734,-87.625813,15327,1674,7055,9759,187,17001
41.8349,-87.61793,8072,1006,3493,5497,88,9078
41.836208,-87.613533,4711,1069,2634,3025,121,5780
41.8367868333333,-87.6133976666667,0,1,1,0,0,1
41.8378,-87.65114,3164,1269,2158,2180,95,4433
41.8378223333333,-87.6512785,0,1,1,0,0,1
41.8378243333333,-87.6512508333333,1,0,1,0,0,1
41.838198,-87.645143,6117,1514,3096,4413,122,7631
41.838271856,-87.645125508,1,0,1,0,0,1
41.8382936666667,-87.6452135,0,1,1,0,0,1
41.838464,-87.635406,3988,736,1699,2983,42,4724
41.8384945,-87.6081738333333,0,1,1,0,0,1
41.838556,-87.608218,4368,4596,2142,5701,1121,8964
41.838842,-87.621857,3740,737,1518,2874,85,4477
41.83920868403,-87.6656098589,1072,486,729,829,0,1558
41.839209,-87.66561,0,48,0,0,48,48
41.84,-87.79,1,0,1,0,0,1
41.84,-87.78,0,2,2,0,0,2
41.84,-87.74,6,19,25,0,0,25
41.84,-87.73,292,624,916,0,0,916
41.84,-87.72,332,531,863,0,0,863
41.84,-87.71,49,182,231,0,0,231
41.84,-87.7,60,202,262,0,0,262
41.84,-87.69,94,40,134,0,0,134
41.84,-87.68,12,13,25,0,0,25
41.84,-87.67,59,149,208,0,0,208
41.84,-87.66,403,162,565,0,0,565
41.84,-87.65,635,260,895,0,0,895
41.84,-87.64,292,162,453,1,0,454
41.84,-87.63,852,138,990,0,0,990
41.84,-87.62,740,152,892,0,0,892
41.84,-87.61,257,294,551,0,0,551
41.84,-87.6,16,19,35,0,0,35
41.84151770807,-87.6851314409,184,90,176,98,0,274
41.841518,-87.685131,0,14,0,0,14,14
41.84163253965,-87.6574349533,1034,624,860,798,0,1658
41.841633,-87.657435,0,55,0,0,55,55
41.841707,-87.626938,1101,333,497,898,39,1434
41.842030168,-87.616837144,0,1,1,0,0,1
41.842052,-87.617,8101,1660,4734,4862,165,9761
41.842733,-87.635491,2830,554,1348,1993,43,3384
41.84358,-87.645368,2439,710,918,2171,60,3149
41.8436799145765,-87.6949685811996,335,113,254,194,0,448
41.84368,-87.694969,0,5,0,0,5,5
41.844462,-87.7020671666667,0,1,1,0,0,1
41.844475,-87.702013,0,27,0,0,27,27
41.84447501366,-87.7020130128,168,244,251,161,0,412
41.844531,-87.715922,0,23,0,0,23,23
41.8445311246216,-87.715921998024,248,272,254,266,0,520
41.845687,-87.622481,1898,916,1429,1278,107,2814
41.845714092,-87.622584939,0,1,1,0,0,1
41.847203,-87.646795,1881,1045,1200,1619,107,2926
41.8481,-87.715068,221,261,288,182,12,482
41.84819094491,-87.7054137458,114,206,224,96,0,320
41.848191,-87.705414,0,22,0,0,22,22
41.84847,-87.685109,829,365,707,462,25,1194
41.84910969176,-87.6951398068,425,271,323,373,0,696
41.84911,-87.69514,0,26,0,0,26,26
41.849110603,-87.694828868,0,1,1,0,0,1
41.8492,-87.67564,551,414,546,390,29,965
41.849527,-87.640591,902,373,432,805,38,1275
41.85,-87.82,1,0,1,0,0,1
41.85,-87.81,0,2,2,0,0,2
41.85,-87.8,0,2,2,0,0,2
41.85,-87.79,1,2,3,0,0,3
41.85,-87.78,1,1,2,0,0,2
41.85,-87.77,1,0,1,0,0,1
41.85,-87.76,0,3,3,0,0,3
41.85,-87.75,2,3,5,0,0,5
41.85,-87.74,10,25,35,0,0,35
41.85,-87.73,75,102,177,0,0,177
41.85,-87.72,216,451,667,0,0,667
41.85,-87.71,111,124,235,0,0,235
41.85,-87.7,371,252,623,0,0,623
41.85,-87.69,900,527,1427,0,0,1427
41.85,-87.68,433,298,730,1,0,731
41.85,-87.67,298,259,557,0,0,557
41.85,-87.66,90,126,216,0,0,216
41.85,-87.65,127,142,267,2,0,269
41.85,-87.64,444,227,671,0,0,671
41.85,-87.63,574,652,1226,0,0,1226
41.85,-87.62,354,562,915,1,0,916
41.85,-87.61,172,262,433,1,0,434
41.85,-87.6,0,1,1,0,0,1
41.8500836934758,-87.6321405172348,1617,889,829,1677,0,2506
41.850084,-87.632141,0,195,0,0,195,195
41.851375,-87.618835,0,743,0,0,743,743
41.8513751729,-87.6188346489,1953,3777,2466,3264,0,5730
41.852619,-87.626488,1936,2184,1813,2068,239,4120
41.8530845574128,-87.6319313049316,5852,4861,4108,6605,0,10713
41.853085,-87.631931,0,933,0,0,933,933
41.853295207,-87.631807566,1,0,1,0,0,1
41.85353363213,-87.7050730318,252,296,359,189,0,548
41.853534,-87.705073,0,56,0,0,56,56
41.8537798107274,-87.6466029882431,1450,859,878,1431,0,2309
41.85378,-87.646603,0,68,0,0,68,68
41.8537878021009,-87.6952461898327,117,73,132,58,0,190
41.853788,-87.695246,0,4,0,0,4,4
41.8537957934734,-87.6958228647709,116,72,87,101,0,188
41.853796,-87.695823,0,4,0,0,4,4
41.853804,-87.695742,0,49,0,0,49,49
41.8538040657915,-87.6957423985004,596,421,525,492,0,1017
41.8540635038745,-87.7151173353195,371,464,566,269,0,835
41.854064,-87.715117,0,33,0,0,33,33
41.854078174,-87.685861111,0,1,1,0,0,1
41.854109,-87.685838,1132,693,968,794,63,1825
41.854184,-87.619154,0,423,0,0,423,423
41.85418424947,-87.6191537415,1895,2322,1957,2260,0,4217
41.8542648333333,-87.6193615,0,1,1,0,0,1
41.8549145757657,-87.6635599136353,2169,1391,1964,1596,0,3560
41.854915,-87.66356,0,79,0,0,79,79
41.8549665187539,-87.6756995916366,2075,1641,1955,1761,0,3716
41.854967,-87.6757,0,116,0,0,116,116
41.855136,-87.654127,1821,1301,1363,1668,91,3122
41.8553748333333,-87.6516608333333,0,1,1,0,0,1
41.856268,-87.613348,858,445,175,1009,119,1303
41.856594,-87.627542,1749,1303,1125,1754,173,3052
41.856802,-87.633879,1230,1402,864,1449,319,2632
41.857411787074,-87.6137915253639,5174,3656,2337,6493,0,8830
41.857412,-87.613792,0,806,0,0,806,806
41.85749495,-87.646031022,1,0,1,0,0,1
41.8575056803172,-87.6459914445877,2764,1386,2060,2090,0,4150
41.857506,-87.645991,0,110,0,0,110,110
41.857556,-87.661535,4193,2846,3541,3290,208,7039
41.857611,-87.619407,4228,3118,2647,4324,375,7346
41.8576175529375,-87.6194107532501,779,170,361,588,0,949
41.857618,-87.619411,0,17,0,0,17,17
41.85763,-87.6194246666667,0,1,1,0,0,1
41.857813,-87.62455,7019,3716,4392,5960,383,10735
41.8578848333333,-87.6685601666667,0,1,1,0,0,1
41.857889,-87.620199,0,54,0,0,54,54
41.8578892427723,-87.6201993227005,1036,400,595,841,0,1436
41.857901,-87.668745,3517,2231,2730,2857,161,5748
41.8579225,-87.668762,0,1,1,0,0,1
41.85795,-87.640826,2370,1426,1811,1875,110,3796
41.858086,-87.651073,3987,2585,3148,3201,223,6572
41.858166,-87.656495,5309,2940,4095,3967,187,8249
41.858277202,-87.656466961,0,1,1,0,0,1
41.86,-87.88,0,1,1,0,0,1
41.86,-87.8,0,1,1,0,0,1
41.86,-87.79,2,2,4,0,0,4
41.86,-87.78,0,1,1,0,0,1
41.86,-87.75,1,2,3,0,0,3
41.86,-87.74,0,5,5,0,0,5
41.86,-87.73,51,96,147,0,0,147
41.86,-87.72,112,198,310,0,0,310
41.86,-87.71,71,162,233,0,0,233
41.86,-87.7,271,534,805,0,0,805
41.86,-87.69,337,232,569,0,0,569
41.86,-87.68,371,250,621,0,0,621
41.86,-87.67,408,301,709,0,0,709
41.86,-87.66,713,646,1355,4,0,1359
41.86,-87.65,810,600,1409,1,0,1410
41.86,-87.64,444,238,682,0,0,682
41.86,-87.63,673,572,1245,0,0,1245
41.86,-87.62,807,703,1510,0,0,1510
41.86,-87.61,545,822,1365,2,0,1367
41.86,-87.58,1,0,1,0,0,1
41.860384,-87.625813,5731,3181,3266,5435,211,8912
41.861267,-87.656625,2251,1311,1671,1784,107,3562
41.86193,-87.69345,0,31,0,0,31,31
41.8619304927826,-87.6934504508972,607,410,509,508,0,1017
41.862378,-87.651062,4134,1374,2250,3177,81,5508
41.8638281740623,-87.6801064610481,8,0,5,3,0,8
41.864059,-87.623727,8398,4704,5246,7434,422,13102
41.864289,-87.6235963333333,0,1,1,0,0,1
41.8644474052394,-87.6823997497559,2,0,2,0,0,2
41.8646,-87.681,0,1,1,0,0,1
41.864830017,-87.647124887,0,1,1,0,0,1
41.864883,-87.647071,8508,3873,5822,6318,241,12381
41.865054,-87.656959,608,474,414,619,49,1082
41.865234,-87.666507,3667,610,1678,2548,51,4277
41.8653003333333,-87.6179295,0,1,1,0,0,1
41.865312,-87.617867,2098,5976,2751,4126,1197,8074
41.8653166666667,-87.6179136666667,0,1,1,0,0,1
41.866064,-87.6073373333333,0,1,1,0,0,1
41.8660831666667,-87.6073626666667,0,1,1,0,0,1
41.866095,-87.607267,5023,10905,4888,8659,2381,15928
41.866131,-87.6072676666667,0,1,1,0,0,1
41.8661343333333,-87.6072721666667,0,1,1,0,0,1
41.866143703,-87.607280254,0,1,1,0,0,1
41.8661681666667,-87.607319,0,1,1,0,0,1
41.86649278172,-87.7064961757,117,269,190,196,0,386
41.866493,-87.706496,0,18,0,0,18,18
41.866501,-87.684697,0,64,0,0,64,64
41.86650148316,-87.68469707,1624,489,1122,991,0,2113
41.866624,-87.694521,319,313,398,216,18,632
41.8671177825,-87.6410879593,6530,3177,4796,4911,0,9707
41.867118,-87.641088,0,260,0,0,260,260
41.8671721666667,-87.6259806666667,0,1,1,0,0,1
41.8672011666667,-87.6153166666667,0,1,1,0,0,1
41.8672086666667,-87.6153443333333,0,1,1,0,0,1
41.86722595682,-87.6153553902,6070,15402,7933,13539,0,21472
41.867226,-87.615355,0,4244,0,0,4244,4244
41.867227,-87.625961,15510,8899,9790,13648,971,24409
41.8672393333333,-87.6154086666667,0,1,1,0,0,1
41.8672473333333,-87.6154411666667,1,0,1,0,0,1
41.8672485,-87.6154456666667,0,1,1,0,0,1
41.8672516666667,-87.61545,0,1,1,0,0,1
41.8672683333333,-87.615432,0,1,1,0,0,1
41.867273,-87.6259438333333,0,1,1,0,0,1
41.867324,-87.648625,7898,1888,3723,5909,154,9786
41.867387056,-87.648665071,1,0,1,0,0,1
41.867491,-87.63219,4875,3022,3757,3844,296,7897
41.8678145,-87.6229903333333,0,1,1,0,0,1
41.8678541666667,-87.6229765,0,1,1,0,0,1
41.867888,-87.623041,15059,13205,9858,16546,1860,28264
41.8679251666667,-87.6229451666667,1,0,1,0,0,1
41.868563,-87.686234,5611,1016,4125,2457,45,6627
41.868765831,-87.659109354,1,0,1,0,0,1
41.868968,-87.659141,6673,2043,3411,5186,119,8716
41.869265,-87.673731,0,70,0,0,70,70
41.8692652184382,-87.6737308502197,6490,947,3278,4159,0,7437
41.8693916666667,-87.6556005,1,0,1,0,0,1
41.8694233333333,-87.655435,1,0,1,0,0,1
41.8694488333333,-87.6554965,0,1,1,0,0,1
41.869482,-87.655486,0,193,0,0,193,193
41.8694821,-87.6554864,11984,2814,6255,8543,0,14798
41.8696207474812,-87.6239812374115,779,1299,929,1149,0,2078
41.869621,-87.623981,0,257,0,0,257,257
41.87,-88.14,1,0,1,0,0,1
41.87,-87.81,3,1,4,0,0,4
41.87,-87.79,1,6,7,0,0,7
41.87,-87.78,0,2,2,0,0,2
41.87,-87.77,42,52,94,0,0,94
41.87,-87.76,7,86,93,0,0,93
41.87,-87.75,15,43,58,0,0,58
41.87,-87.74,14,22,36,0,0,36
41.87,-87.73,20,110,130,0,0,130
41.87,-87.72,28,69,97,0,0,97
41.87,-87.71,267,140,407,0,0,407
41.87,-87.7,164,158,322,0,0,322
41.87,-87.69,1220,562,1781,1,0,1782
41.87,-87.68,1083,308,1391,0,0,1391
41.87,-87.67,1469,462,1931,0,0,1931
41.87,-87.66,2000,685,2682,3,0,2685
41.87,-87.65,2527,852,3376,3,0,3379
41.87,-87.64,1316,874,2187,3,0,2190
41.87,-87.63,2343,1892,4228,7,0,4235
41.87,-87.62,1192,2130,3318,4,0,3322
41.87,-87.61,370,928,1298,0,0,1298
41.870217919,-87.639477372,1,0,1,0,0,1
41.870257,-87.639474,5525,2475,3445,4337,218,8000
41.870769,-87.625734,10321,6471,6399,9600,793,16792
41.870816,-87.631246,3878,2175,2452,3452,149,6053
41.871262,-87.673688,11284,1150,4957,7401,76,12434
41.871419191,-87.673671126,1,0,1,0,0,1
41.87146651779,-87.6409491327,885,375,518,742,0,1260
41.871467,-87.640949,0,49,0,0,49,49
41.871514,-87.669886,5975,765,2841,3848,51,6740
41.871737,-87.65103,15740,2808,8038,10320,190,18548
41.8717548333333,-87.6690745,1,0,1,0,0,1
41.8718181666667,-87.6546956666667,1,0,1,0,0,1
41.87184,-87.64664,16024,2998,7857,10973,192,19022
41.8720028333333,-87.6299761666667,1,0,1,0,0,1
41.872004986,-87.650851607,1,0,1,0,0,1
41.87207763285,-87.6295437729,13311,5925,7374,11862,0,19236
41.872078,-87.629544,0,486,0,0,486,486
41.872095227,-87.629607797,0,1,1,0,0,1
41.872131,-87.746619,36,89,56,65,4,125
41.8721421666667,-87.6295325,0,1,1,0,0,1
41.872168,-87.66155,0,5,0,0,5,5
41.872168314881,-87.6615495979786,455,87,158,384,0,542
41.872185,-87.661582,0,1,1,0,0,1
41.872187,-87.661501,16984,2611,7540,11890,165,19595
41.8721923333333,-87.6612265,1,0,1,0,0,1
41.8722287322403,-87.6613638550043,5211,420,2604,3027,0,5631
41.872229,-87.661364,0,17,0,0,17,17
41.8724933333333,-87.6240535,0,1,1,0,0,1
41.872541308,-87.624191642,1,0,1,0,0,1
41.872596,-87.633502,1621,524,883,1235,27,2145
41.872612119,-87.623889685,0,1,1,0,0,1
41.872682214,-87.623924851,0,1,1,0,0,1
41.8727315422631,-87.6335164904594,6300,2885,4289,4896,0,9185
41.872732,-87.633516,0,158,0,0,158,158
41.872773,-87.623981,5952,10524,5306,9303,1867,16476
41.8727853333333,-87.6239103333333,0,1,1,0,0,1
41.87295,-87.66913,7017,1224,3578,4631,32,8241
41.872993,-87.764499,32,112,69,63,12,144
41.873061,-87.669135,0,7,0,0,7,7
41.8730610878979,-87.6691348850727,2163,206,1048,1321,0,2369
41.87359967462,-87.7048707493,136,92,136,92,0,228
41.8736,-87.704871,0,4,0,0,4,4
41.874053,-87.627716,3866,3951,2808,4495,514,7817
41.8742545,-87.6277275,1,0,1,0,0,1
41.874255,-87.639573,2187,831,1014,1922,82,3018
41.874325,-87.725704,13,19,24,7,1,32
41.87441,-87.726092,0,8,0,0,8,8
41.8744102100382,-87.726091593504,59,102,86,75,0,161
41.8746391666667,-87.6863651666667,0,1,1,0,0,1
41.87464,-87.65703,6925,1389,3235,5014,65,8314
41.87474885079,-87.6864452757,3139,1062,1963,2238,0,4201
41.874749,-87.686445,0,72,0,0,72,72
41.874754,-87.649807,10400,3454,6011,7565,278,13854
41.87501,-87.67328,2821,932,1702,1992,59,3753
41.8750236280333,-87.6330940425396,6296,1898,3470,4724,0,8194
41.875024,-87.633094,0,196,0,0,196,196
41.875679,-87.71547,72,110,76,88,18,182
41.875806,-87.755285,20,48,29,36,3,68
41.875885,-87.640795,3447,1511,2174,2690,94,4958
41.8759326655,-87.6305845355,5145,1427,2295,4277,0,6572
41.875933,-87.630585,0,255,0,0,255,255
41.876176476,-87.630533695,0,1,1,0,0,1
41.8762221666667,-87.6244855,1,0,1,0,0,1
41.876243,-87.624426,3170,5023,2789,4428,976,8193
41.876268,-87.629155,4407,2933,2817,4157,366,7340
41.876423,-87.620339,470,2106,828,1253,495,2576
41.8765108333333,-87.6203341666667,0,1,1,0,0,1
41.876535,-87.620473,0,831,0,0,831,831
41.8765351944122,-87.62047290802,689,2704,1062,2331,0,3393
41.877181,-87.627844,7104,3448,4052,6098,402,10552
41.877245,-87.639366,9680,3448,6424,6434,270,13128
41.8774228333333,-87.6353663333333,1,0,1,0,0,1
41.8774426666667,-87.628571,0,1,1,0,0,1
41.8775321666667,-87.6494715,1,0,1,0,0,1
41.877613,-87.745405,13,114,86,34,7,127
41.877618,-87.673895,1226,887,997,977,139,2113
41.8776338333333,-87.635288,0,1,1,0,0,1
41.8776415962753,-87.6496177911758,13904,4995,8008,10891,0,18899
41.877642,-87.649618,0,283,0,0,283,283
41.8777079559,-87.6353211408,13389,5394,8482,10301,0,18783
41.877708,-87.635321,0,770,0,0,770,770
41.877726,-87.654787,0,159,0,0,159,159
41.87772613,-87.65478743,9480,3657,5627,7510,0,13137
41.877770901,-87.649601936,0,1,1,0,0,1
41.8777885,-87.6547038333333,0,1,1,0,0,1
41.8778348333333,-87.6240703333333,0,1,1,0,0,1
41.877846599,-87.635406017,0,1,1,0,0,1
41.87785,-87.62408,5321,8069,4233,7562,1595,13390
41.877917,-87.735737,369,64,312,116,5,433
41.877945,-87.662007,5069,1889,2033,4783,142,6958
41.878030658,-87.631946445,1,0,1,0,0,1
41.8780731666667,-87.6302298333333,0,1,1,0,0,1
41.878086329,-87.643911839,0,1,1,0,0,1
41.8781008333333,-87.635499,1,0,1,0,0,1
41.8781189009123,-87.6439476013184,10096,2962,6229,6829,0,13058
41.878119,-87.643948,0,150,0,0,150,150
41.878166,-87.631929,12942,3380,7211,8805,306,16322
41.8783166118307,-87.6409810781479,16208,5036,9630,11614,0,21244
41.878317,-87.640981,0,427,0,0,427,427
41.878415346,-87.644064426,0,1,1,0,0,1
41.8784738333333,-87.6311391666667,1,0,1,0,0,1
41.879255,-87.639904,19264,5861,11069,13541,515,25125
41.879344,-87.631985,0,197,0,0,197,197
41.87934437346,-87.6319852213,3784,1738,2199,3323,0,5522
41.879356,-87.629791,0,457,0,0,457,457
41.8793563587,-87.6297910363,7500,2747,3803,6444,0,10247
41.879434,-87.635504,0,553,0,0,553,553
41.8794340914001,-87.6355040073395,7411,3296,5025,5682,0,10707
41.879472,-87.625689,0,587,0,0,587,587
41.87947235235,-87.6256886059,6996,3774,4566,6204,0,10770
41.8796396666667,-87.6256098333333,0,1,1,0,0,1
41.8797877089,-87.686112808,1905,757,1274,1388,0,2662
41.879788,-87.686113,0,78,0,0,78,78
41.879834056,-87.68611598,1,0,1,0,0,1
41.879868,-87.642933,0,1,1,0,0,1
41.88,-87.84,0,2,2,0,0,2
41.88,-87.83,0,1,1,0,0,1
41.88,-87.82,1,1,2,0,0,2
41.88,-87.81,0,2,2,0,0,2
41.88,-87.8,3,1,4,0,0,4
41.88,-87.79,4,3,7,0,0,7
41.88,-87.78,3,5,8,0,0,8
41.88,-87.77,16,60,76,0,0,76
41.88,-87.76,78,64,142,0,0,142
41.88,-87.75,34,71,105,0,0,105
41.88,-87.74,63,85,148,0,0,148
41.88,-87.73,66,113,179,0,0,179
41.88,-87.72,56,62,118,0,0,118
41.88,-87.71,80,209,289,0,0,289
41.88,-87.7,191,197,388,0,0,388
41.88,-87.69,408,399,807,0,0,807
41.88,-87.68,487,384,871,0,0,871
41.88,-87.67,1160,843,2002,1,0,2003
41.88,-87.66,2544,1482,3835,191,0,4026
41.88,-87.65,5812,3832,9635,9,0,9644
41.88,-87.64,5360,2856,8167,49,0,8216
41.88,-87.63,7946,4745,12667,24,0,12691
41.88,-87.62,1883,3555,5435,3,0,5438
41.88,-87.61,212,360,572,0,0,572
41.880121,-87.763238,133,92,61,157,7,225
41.880207,-87.755337,127,113,142,85,13,240
41.880281,-87.774453,193,147,186,113,41,340
41.880317,-87.635185,12877,3877,8794,7645,315,16754
41.8803296336346,-87.6427459716797,7237,2308,4225,5320,0,9545
41.88033,-87.642746,0,158,0,0,158,158
41.880419,-87.655519,8705,2795,4541,6750,209,11500
41.8805243333333,-87.635881,1,0,1,0,0,1
41.8805405,-87.6554295,1,0,1,0,0,1
41.880708,-87.741018,55,81,87,47,2,136
41.88085,-87.727907,41,105,74,61,11,146
41.8808506666667,-87.6301665,0,1,1,0,0,1
41.8809431666667,-87.6167825,0,1,1,0,0,1
41.8809531666667,-87.616743,0,1,1,0,0,1
41.8809568333333,-87.6167776666667,1,0,1,0,0,1
41.880958,-87.616743,11112,30520,11877,23386,6369,41632
41.8809615,-87.6167733333333,0,1,1,0,0,1
41.880999923,-87.616716027,0,1,1,0,0,1
41.8810165,-87.6167958333333,0,1,1,0,0,1
41.8810175,-87.6167526666667,0,1,1,0,0,1
41.8810317,-87.62408432,9571,21444,12306,18709,0,31015
41.881032,-87.624084,0,6460,0,0,6460,6460
41.8810636666667,-87.6240553333333,0,1,1,0,0,1
41.8811296666667,-87.6238848333333,0,1,1,0,0,1
41.881135,-87.616781,0,1,1,0,0,1
41.8811645,-87.6241133333333,0,1,1,0,0,1
41.881286,-87.6241023333333,0,1,1,0,0,1
41.881319815,-87.6295209193,15128,4851,7906,12073,0,19979
41.88132,-87.629521,0,579,0,0,579,579
41.88137,-87.67493,1901,1582,1651,1675,157,3483
41.8814138333333,-87.6748463333333,0,1,1,0,0,1
41.8815183333333,-87.6401295,0,1,1,0,0,1
41.88169,-87.63953,11331,3714,7147,7578,320,15045
41.8817263333333,-87.6484043333333,0,1,1,0,0,1
41.881800413,-87.64078784,0,1,1,0,0,1
41.881827,-87.648832,0,1,0,0,1,1
41.8818273765714,-87.6488319039345,389,106,167,328,0,495
41.881859,-87.649264,0,28,0,0,28,28
41.8818593280382,-87.6492637395859,3073,655,1917,1811,0,3728
41.8818798,-87.6489482,2,0,2,0,0,2
41.881892,-87.648789,14492,7437,9488,12055,386,21929
41.8818988333333,-87.648521,1,0,1,0,0,1
41.8819955,-87.6254596666667,0,1,1,0,0,1
41.882091,-87.639833,9149,3370,5167,7046,306,12519
41.882134,-87.625125,6615,5068,4831,6163,689,11683
41.882242,-87.641066,14839,5510,8472,11570,307,20349
41.882409,-87.639767,2772,731,1615,1888,0,3503
41.882567167,-87.641298413,0,1,1,0,0,1
41.882583,-87.6415106666667,0,1,1,0,0,1
41.882664,-87.63253,7458,2903,5006,5142,213,10361
41.8827519656856,-87.641190290451,8548,2013,5616,4945,0,10561
41.882752,-87.64119,0,75,0,0,75,75
41.882760763,-87.641311526,0,1,1,0,0,1
41.8828198615511,-87.6395916938782,1221,404,732,893,0,1625
41.88282,-87.639592,0,88,0,0,88,88
41.88283,-87.661206,6078,3433,4319,5076,116,9511
41.8828595,-87.6612845,1,0,1,0,0,1
41.883073,-87.656952,4194,1867,2705,3257,99,6061
41.8830878333333,-87.6318851666667,0,1,1,0,0,1
41.883143,-87.637242,0,171,0,0,171,171
41.8831433643902,-87.6372420787811,8292,2703,5637,5358,0,10995
41.883165,-87.6511,7263,3170,4549,5744,140,10433
41.883181,-87.648725,0,230,0,0,230,230
41.8831813059739,-87.6487246155739,5715,3803,4104,5414,0,9518
41.8832953333333,-87.6509798333333,1,0,1,0,0,1
41.88338,-87.64117,25451,5543,14538,16123,333,30994
41.8834228333333,-87.6508123333333,1,0,1,0,0,1
41.883457661,-87.641469121,1,0,1,0,0,1
41.883543491,-87.648580909,0,1,1,0,0,1
41.8835973333333,-87.6486845,0,1,1,0,0,1
41.8836016572752,-87.6486267149448,6512,5571,5110,6973,0,12083
41.883602,-87.648627,0,267,0,0,267,267
41.883610129,-87.648707747,1,0,1,0,0,1
41.8836876666667,-87.6488505,0,1,1,0,0,1
41.8838191666667,-87.6245938333333,0,1,1,0,0,1
41.8838238333333,-87.6246181666667,1,0,1,0,0,1
41.8838733333333,-87.6484086666667,0,1,1,0,0,1
41.883984,-87.624684,0,2026,0,0,2026,2026
41.8839840647265,-87.6246839761734,14791,10050,9513,15328,0,24841
41.8840133333333,-87.6243873333333,1,0,1,0,0,1
41.8840343333333,-87.624372,0,1,1,0,0,1
41.884069,-87.656853,4262,2159,2733,3591,97,6421
41.884114,-87.654264,8717,4187,5892,6761,251,12904
41.8841605,-87.6542803333333,0,1,1,0,0,1
41.884241,-87.629634,12716,4814,6791,10347,392,17530
41.884348631,-87.62940681,0,1,1,0,0,1
41.884420276,-87.632022619,1,0,1,0,0,1
41.8844261666667,-87.6241783333333,1,0,1,0,0,1
41.88444674,-87.640219569,1,0,1,0,0,1
41.88445395657,-87.6962981368,538,412,634,316,0,950
41.884454,-87.696298,0,44,0,0,44,44
41.884491,-87.627872,1,0,1,0,0,1
41.884545326,-87.627962351,0,1,1,0,0,1
41.884576,-87.63189,0,392,0,0,392,392
41.884576228,-87.63188991,12491,3861,6574,9778,0,16352
41.884599805,-87.631832123,1,0,1,0,0,1
41.884603,-87.706304,0,34,0,0,34,34
41.88460328501,-87.7063037436,645,366,733,278,0,1011
41.884616,-87.644571,0,233,0,0,233,233
41.88461618962,-87.6445705849,8196,3905,5564,6537,0,12101
41.884621,-87.627834,0,1060,0,0,1060,1060
41.8846210725794,-87.6278342306614,12455,7458,8131,11782,0,19913
41.8846421666667,-87.6273436666667,0,1,1,0,0,1
41.884723,-87.6276676666667,0,1,1,0,0,1
41.884728,-87.619521,11391,6415,8141,8805,860,17806
41.8848876666667,-87.6276456666667,0,1,1,0,0,1
41.8853633333333,-87.6413523333333,0,1,1,0,0,1
41.885409,-87.726491,58,140,119,70,9,198
41.8854643333333,-87.6424551666667,0,1,1,0,0,1
41.885485768,-87.652360439,1,0,1,0,0,1
41.8854917062691,-87.6522892713547,4216,2583,2725,4074,0,6799
41.885492,-87.652289,0,163,0,0,163,163
41.885502,-87.716866,434,566,551,386,63,1000
41.8855188333333,-87.6426346666667,0,1,1,0,0,1
41.8855203333333,-87.6523488333333,1,0,1,0,0,1
41.885637,-87.641823,15650,5163,9135,11432,246,20813
41.8856375,-87.6243081666667,0,1,1,0,0,1
41.8857368333333,-87.624602,0,1,1,0,0,1
41.885779,-87.651025,0,551,0,0,551,551
41.8857792524043,-87.6510246098041,13054,7650,8316,12388,0,20704
41.885837,-87.6355,12184,5145,8449,8573,307,17329
41.8858853333333,-87.6248416666667,1,0,1,0,0,1
41.88592,-87.66717,3076,2594,2679,2862,129,5670
41.885928,-87.73541,25,65,56,31,3,90
41.885951,-87.677009,2282,1591,2119,1681,73,3873
41.8859893333333,-87.6510208333333,0,1,1,0,0,1
41.88602082773,-87.6308760584,11296,5210,6949,9557,0,16506
41.886021,-87.630876,0,598,0,0,598,598
41.886022,-87.624398,1291,373,702,962,0,1664
41.886024,-87.624117,12846,9954,8367,12797,1636,22800
41.886026,-87.624377,0,55,0,0,55,55
41.8861213333333,-87.6233413333333,0,1,1,0,0,1
41.886247873,-87.624516845,0,1,1,0,0,1
41.886349,-87.617517,0,579,0,0,579,579
41.88634906269,-87.6175165471,7871,5207,6628,6450,0,13078
41.886616,-87.65804,0,85,0,0,85,85
41.8866164860277,-87.6580399274826,3471,1474,2462,2483,0,4945
41.8867107731844,-87.6596572995186,1856,626,1490,992,0,2482
41.886711,-87.659657,0,6,0,0,6,6
41.886835,-87.62232,7631,4664,6038,5727,530,12295
41.886841,-87.745261,41,221,181,72,9,262
41.886861801,-87.626065612,0,1,1,0,0,1
41.886875,-87.62603,6250,7590,5308,7191,1341,13840
41.8868796666667,-87.6127846666667,0,1,1,0,0,1
41.88691,-87.6127736666667,0,1,1,0,0,1
41.8869191666667,-87.6127891666667,0,1,1,0,0,1
41.886919618,-87.625962615,0,1,1,0,0,1
41.8869208333333,-87.6127908333333,0,1,1,0,0,1
41.886976,-87.612813,6107,13854,6306,11064,2591,19961
41.887102842,-87.612841249,0,1,1,0,0,1
41.88711679,-87.61283493,0,1,1,0,0,1
41.8871363333333,-87.6128131666667,0,1,1,0,0,1
41.887318,-87.6268783333333,0,1,1,0,0,1
41.887664,-87.765469,110,166,151,114,11,276
41.887832,-87.755527,79,114,137,51,5,193
41.887919,-87.774446,3,11,7,7,0,14
41.8879437942721,-87.774273455143,206,245,287,164,0,451
41.887944,-87.774273,0,25,0,0,25,25
41.888059607176,-87.7742654085159,25,15,23,17,0,40
41.88806,-87.774265,0,4,0,0,4,4
41.888243,-87.63639,14007,4766,9294,9236,243,18773
41.888716,-87.644448,0,250,0,0,250,250
41.888716036,-87.6444478533,15628,6171,9704,12095,0,21799
41.888720989,-87.627439857,0,1,1,0,0,1
41.8887991666667,-87.6271006666667,0,1,1,0,0,1
41.8889575,-87.6445025,1,0,1,0,0,1
41.8891111666667,-87.6386543333333,0,1,1,0,0,1
41.88917683258,-87.6385057718,28827,8087,15596,21318,0,36914
41.889177,-87.638506,0,340,0,0,340,340
41.889187,-87.627754,2164,820,1170,1688,126,2984
41.8892938333333,-87.6385186666667,0,1,1,0,0,1
41.889375,-87.627077,0,614,0,0,614,614
41.8893754666317,-87.6270765066147,9697,4933,6667,7963,0,14630
41.88949181977,-87.6882193648,1809,736,1553,992,0,2545
41.889492,-87.688219,0,52,0,0,52,52
41.8894963333333,-87.68807,1,0,1,0,0,1
41.8895,-87.688257,505,79,370,214,0,584
41.8895333333333,-87.6880566666667,0,1,1,0,0,1
41.8897049264408,-87.6878660917282,467,152,396,223,0,619
41.889705,-87.687866,0,6,0,0,6,6
41.88979,-87.634226,0,1,1,0,0,1
41.889899,-87.671473,3105,1729,2178,2596,60,4834
41.889906,-87.634266,18321,8343,11784,14466,414,26664
41.8899545160741,-87.6806509494781,47,7,26,28,0,54
41.889955,-87.680651,0,11,0,0,11,11
41.889967,-87.680156,0,7,0,0,7,7
41.8899674947083,-87.6801560819149,145,31,115,61,0,176
41.8899793333333,-87.6255951666667,0,1,1,0,0,1
41.89,-87.85,0,1,1,0,0,1
41.89,-87.84,0,1,1,0,0,1
41.89,-87.81,2,3,5,0,0,5
41.89,-87.8,6,13,19,0,0,19
41.89,-87.79,0,4,4,0,0,4
41.89,-87.78,6,14,20,0,0,20
41.89,-87.77,57,131,188,0,0,188
41.89,-87.76,63,86,149,0,0,149
41.89,-87.75,30,81,111,0,0,111
41.89,-87.74,8,30,38,0,0,38
41.89,-87.73,52,71,123,0,0,123
41.89,-87.72,250,252,502,0,0,502
41.89,-87.71,124,135,259,0,0,259
41.89,-87.7,434,274,708,0,0,708
41.89,-87.69,372,234,605,1,0,606
41.89,-87.68,1374,796,2164,6,0,2170
41.89,-87.67,826,701,1527,0,0,1527
41.89,-87.66,2584,1697,4281,0,0,4281
41.89,-87.65,12557,7685,20131,111,0,20242
41.89,-87.64,5268,2392,7633,27,0,7660
41.89,-87.63,9210,6085,15245,50,0,15295
41.89,-87.62,5398,4561,9911,48,0,9959
41.89,-87.61,1195,4246,5435,6,0,5441
41.89,-87.6,100,164,263,1,0,264
41.890028,-87.636618,7083,2898,4506,5376,99,9981
41.890146136,-87.634396672,0,1,1,0,0,1
41.890173,-87.626185,7300,3959,4686,6100,473,11259
41.890358,-87.6266736666667,1,0,1,0,0,1
41.8904687924386,-87.7026075124741,330,175,230,275,0,505
41.890469,-87.702608,0,9,0,0,9,9
41.8905445,-87.6313598333333,0,1,1,0,0,1
41.890573,-87.622072,7217,5377,5425,6344,825,12594
41.8906128333333,-87.6185911666667,1,0,1,0,0,1
41.8906758333333,-87.6315776666667,0,1,1,0,0,1
41.8907278333333,-87.6315923333333,0,1,1,0,0,1
41.890762,-87.631697,15236,11775,11869,14178,964,27011
41.890762,-87.6315118333333,0,1,1,0,0,1
41.8907763333333,-87.6316011666667,0,1,1,0,0,1
41.890847,-87.618617,0,1098,0,0,1098,1098
41.8908470406238,-87.6186168193817,13344,8842,9336,12850,0,22186
41.8908571666667,-87.618751,0,1,1,0,0,1
41.8909331666667,-87.6179456666667,0,1,1,0,0,1
41.8909941666667,-87.6353885,1,0,1,0,0,1
41.891023,-87.63548,0,232,0,0,232,232
41.8910233102519,-87.6354798674583,9874,5443,6749,8568,0,15317
41.891060591,-87.635418296,0,1,1,0,0,1
41.891072,-87.666611,4304,2507,3124,3570,117,6811
41.891075,-87.6666033333333,0,1,1,0,0,1
41.8910815,-87.6666771666667,0,1,1,0,0,1
41.891264,-87.676842,0,19,0,0,19,19
41.8912643464815,-87.676842212677,567,147,426,288,0,714
41.891466,-87.626761,17797,12703,12079,16750,1671,30500
41.891476274,-87.626716614,0,1,1,0,0,1
41.8915561666667,-87.6482371666667,0,1,1,0,0,1
41.891578,-87.648384,10466,6097,8184,8074,305,16563
41.89163065,-87.620559812,1,0,1,0,0,1
41.891795,-87.658751,7683,3732,5470,5816,129,11415
41.891847,-87.62058,0,1194,0,0,1194,1194
41.8918473721099,-87.6205801963806,12361,7980,8138,12203,0,20341
41.8920273333333,-87.6891725,1,0,1,0,0,1
41.892048,-87.689397,1471,991,1436,950,76,2462
41.8921756666667,-87.611975,0,1,1,0,0,1
41.8921796666667,-87.6118188333333,0,1,1,0,0,1
41.8921971666667,-87.6120713333333,0,1,1,0,0,1
41.892209649,-87.611886263,1,0,1,0,0,1
41.8922106666667,-87.6119391666667,0,1,1,0,0,1
41.892212272,-87.611931086,0,1,1,0,0,1
41.8922206666667,-87.6120243333333,0,1,1,0,0,1
41.8922316666667,-87.61196,0,1,1,0,0,1
41.8922371666667,-87.6121881666667,0,1,1,0,0,1
41.892238855,-87.611872196,0,1,1,0,0,1
41.892244339,-87.611945868,0,1,1,0,0,1
41.8922563333333,-87.6121401666667,0,1,1,0,0,1
41.892266,-87.6122315,0,1,1,0,0,1
41.892277598,-87.612094164,0,1,1,0,0,1
41.892278,-87.612043,16451,61733,22485,42209,13490,78184
41.8922903333333,-87.6122806666667,0,1,1,0,0,1
41.8922973333333,-87.6121356666667,1,0,1,0,0,1
41.8922988333333,-87.612317,0,1,1,0,0,1
41.892298937,-87.611994743,0,1,1,0,0,1
41.892375588,-87.61224246,0,1,1,0,0,1
41.892394,-87.676885,0,97,0,0,97,97
41.8923944529627,-87.6768851280212,3979,1950,3173,2756,0,5929
41.8925263333333,-87.6185555,0,1,1,0,0,1
41.8925881666667,-87.6167205,0,1,1,0,0,1
41.892592,-87.617289,0,1134,0,0,1134,1134
41.8925921197097,-87.6172891259193,12562,9378,8604,13336,0,21940
41.892926455,-87.617298245,0,1,1,0,0,1
41.893808,-87.641697,0,191,0,0,191,191
41.8938080562436,-87.6416972279549,13884,5446,8518,10812,0,19330
41.893992,-87.629318,19333,10047,11858,16674,848,29380
41.8940366666667,-87.6418051666667,0,1,1,0,0,1
41.8941325,-87.6293008333333,0,1,1,0,0,1
41.8942456666667,-87.6227675,0,1,1,0,0,1
41.8943441666667,-87.6288676666667,0,1,1,0,0,1
41.894345,-87.622798,0,1234,0,0,1234,1234
41.8943451374243,-87.6227983832359,19239,8025,11872,15392,0,27264
41.8943968333333,-87.6287628333333,1,0,1,0,0,1
41.8943983333333,-87.623138,1,0,1,0,0,1
41.894503,-87.617854,12472,4783,6557,10232,466,17255
41.894556,-87.653449,7397,3720,6004,5024,89,11117
41.8945681666667,-87.6177735,1,0,1,0,0,1
41.894588,-87.6343538333333,0,1,1,0,0,1
41.8946606666667,-87.6383418333333,1,0,1,0,0,1
41.894664526,-87.634599686,0,1,1,0,0,1
41.894666,-87.638437,8550,3344,4953,6811,130,11894
41.8947155,-87.6346598333333,0,1,1,0,0,1
41.894722,-87.634362,18499,9442,12264,15312,365,27941
41.894745,-87.756895,68,151,122,88,9,219
41.8948123333333,-87.6347796666667,0,1,1,0,0,1
41.8948405,-87.6341175,0,1,1,0,0,1
41.8948755,-87.634352,1,0,1,0,0,1
41.894877,-87.632326,7947,5320,5498,7354,415,13267
41.894887,-87.774704,153,153,138,147,21,306
41.894958,-87.764902,297,211,270,229,9,508
41.8951727127816,-87.6675470173359,2740,1603,2056,2287,0,4343
41.895173,-87.667547,0,80,0,0,80,80
41.8951996662016,-87.6676046848297,14,3,6,11,0,17
41.895465,-87.706128,0,51,0,0,51,51
41.89546530305,-87.7061278837,581,521,528,574,0,1102
41.895501,-87.682017,3407,2639,3062,2826,158,6046
41.8955434694899,-87.6029205322265,3,4,1,6,0,7
41.895586729,-87.626260042,0,1,1,0,0,1
41.895603,-87.6227885,1,0,1,0,0,1
41.895634,-87.672069,5381,2965,3706,4502,138,8346
41.895748,-87.620104,7024,2408,3896,5207,329,9432
41.89576474564,-87.6259080327,11701,4970,6916,9755,0,16671
41.895765,-87.625908,0,672,0,0,672,672
41.895769,-87.67722,8479,4867,6845,6267,234,13346
41.895954,-87.667728,0,10,0,0,10,10
41.895954357343,-87.6677280664444,900,266,615,551,0,1166
41.895974,-87.667725,0,26,0,0,26,26
41.8959743225961,-87.6677253842354,1270,440,827,883,0,1710
41.8963233333333,-87.7013923333333,1,0,1,0,0,1
41.896362,-87.654061,0,190,0,0,190,190
41.896362458,-87.6540612729,8868,4539,6628,6779,0,13407
41.8963713333333,-87.6541128333333,1,0,1,0,0,1
41.896373,-87.660984,0,162,0,0,162,162
41.89637337,-87.66098386,6359,3598,4552,5405,0,9957
41.8963736666667,-87.6541448333333,1,0,1,0,0,1
41.8964031666667,-87.66099,0,1,1,0,0,1
41.896617,-87.628579,0,519,0,0,519,519
41.8966172004075,-87.628578543663,16619,6647,9938,13328,0,23266
41.8967469730938,-87.6356676220894,12519,5230,8076,9673,0,17749
41.896747,-87.635668,0,196,0,0,196,196
41.89675,-87.63089,7937,4482,5100,7087,232,12419
41.8969338333333,-87.6288565,0,1,1,0,0,1
41.8969446263708,-87.6217576861382,11719,4893,6914,9698,0,16612
41.896945,-87.621758,0,699,0,0,699,699
41.8969645,-87.6219195,1,0,1,0,0,1
41.897037625,-87.621731639,0,1,1,0,0,1
41.8972895,-87.6250313333333,1,0,1,0,0,1
41.8973263333333,-87.6238116666667,0,1,1,0,0,1
41.8973798607232,-87.6344203948975,827,223,400,650,0,1050
41.89738,-87.63442,0,6,0,0,6,6
41.8974455,-87.628652,0,1,1,0,0,1
41.897448,-87.628722,6232,2496,3689,4805,234,8728
41.89766,-87.62351,5620,5836,3918,6424,1114,11456
41.897764,-87.642884,17428,4730,10745,11201,212,22158
41.898203,-87.637536,6579,3492,4373,5564,134,10071
41.89841768945,-87.6865960164,4845,3455,4284,4016,0,8300
41.898418,-87.686596,0,230,0,0,230,230
41.8985866514,-87.6219152258,10649,5631,6608,9672,0,16280
41.898587,-87.621915,0,850,0,0,850,850
41.8986633333333,-87.6226171666667,0,1,1,0,0,1
41.898930788,-87.630063057,1,0,1,0,0,1
41.898969,-87.629912,15870,8096,9766,13699,501,23966
41.8990423333333,-87.6721613333333,0,1,1,0,0,1
41.899181,-87.6722,4285,2106,3241,3072,78,6391
41.8992248333333,-87.67218,1,0,1,0,0,1
41.8992601666667,-87.6298835,0,1,1,0,0,1
41.89939,-87.648545,0,33,0,0,33,33
41.899390285497,-87.6485449075699,1433,587,1052,968,0,2020
41.899643,-87.6677,5669,2269,3551,4282,105,7938
41.899644136,-87.668493629,0,1,1,0,0,1
41.89993,-87.63443,0,192,0,0,192,192
41.89993001,-87.63443007,7039,2969,3622,6386,0,10008
41.9,-88.05,0,1,1,0,0,1
41.9,-87.92,3,0,3,0,0,3
41.9,-87.89,0,1,1,0,0,1
41.9,-87.82,1,0,1,0,0,1
41.9,-87.81,0,2,2,0,0,2
41.9,-87.79,0,1,1,0,0,1
41.9,-87.78,7,5,12,0,0,12
41.9,-87.77,32,121,153,0,0,153
41.9,-87.76,25,155,180,0,0,180
41.9,-87.75,197,351,548,0,0,548
41.9,-87.74,17,38,55,0,0,55
41.9,-87.73,134,287,421,0,0,421
41.9,-87.72,298,511,809,0,0,809
41.9,-87.71,599,625,1224,0,0,1224
41.9,-87.7,1378,1227,2605,0,0,2605
41.9,-87.69,3545,2065,5609,1,0,5610
41.9,-87.68,2015,1847,3861,1,0,3862
41.9,-87.67,2406,1769,4175,0,0,4175
41.9,-87.66,1322,903,2209,16,0,2225
41.9,-87.65,1229,647,1875,1,0,1876
41.9,-87.64,2781,1494,4274,1,0,4275
41.9,-87.63,7651,4504,12141,14,0,12155
41.9,-87.62,3390,3800,7175,15,0,7190
41.9,-87.61,29,57,86,0,0,86
41.900219,-87.642985,0,94,0,0,94,94
41.90021949323,-87.6429854676,6676,1886,3468,5094,0,8562
41.900363,-87.696704,4219,3633,4581,3070,201,7852
41.9004056666667,-87.6966625,1,0,1,0,0,1
41.90068,-87.6626,6083,3048,3950,4976,205,9131
41.9007101666667,-87.6626095,0,1,1,0,0,1
41.900954127,-87.623769522,0,1,1,0,0,1
41.90096,-87.623777,0,4600,0,0,4600,4600
41.90096039,-87.62377664,14794,22494,13587,23701,0,37288
41.900966,-87.6239001666667,0,1,1,0,0,1
41.9009661666667,-87.66259,1,0,1,0,0,1
41.9009948333333,-87.6237885,0,1,1,0,0,1
41.9010096666667,-87.6237895,0,1,1,0,0,1
41.9011166666667,-87.623586,0,1,1,0,0,1
41.901315,-87.677409,4996,2873,3515,4222,132,7869
41.90230870122,-87.627690528,11513,6866,8275,10104,0,18379
41.902309,-87.627691,0,643,0,0,643,643
41.9023356666667,-87.6279081666667,0,1,1,0,0,1
41.9025441666667,-87.6314816666667,0,1,1,0,0,1
41.902705669,-87.709194779,0,1,1,0,0,1
41.90270659438,-87.709219571,1928,1118,2090,956,0,3046
41.902707,-87.70922,0,80,0,0,80,80
41.9027316666667,-87.7092941666667,0,1,1,0,0,1
41.9028778333333,-87.631809,0,1,1,0,0,1
41.9028916666667,-87.6874195,0,1,1,0,0,1
41.902893,-87.687275,3400,2599,3050,2791,158,5999
41.902901,-87.631282,0,4,4,0,0,4
41.902924,-87.637715,3898,1900,2463,3264,71,5798
41.902973,-87.63128,25945,12831,15117,23065,594,38776
41.902997,-87.683825,3289,1639,2197,2643,88,4928
41.903029,-87.697474,2768,2565,2671,2470,192,5333
41.903119,-87.673935,8048,5359,6729,6493,185,13407
41.9031385,-87.6737736666667,0,1,1,0,0,1
41.9031446666667,-87.673834,0,1,1,0,0,1
41.903222,-87.634324,21694,12348,14273,19299,470,34042
41.9032436666667,-87.6741666666667,1,0,1,0,0,1
41.9032615,-87.6311495,1,0,1,0,0,1
41.903266,-87.678435,6679,4112,5438,5162,191,10791
41.9032783333333,-87.678443,0,1,1,0,0,1
41.903396726,-87.6578511,1,0,1,0,0,1
41.90345,-87.667747,16828,9411,12344,13341,554,26239
41.9034728333333,-87.667877,1,0,1,0,0,1
41.903486,-87.643353,0,193,0,0,193,193
41.90348607004,-87.6433534936,8365,4168,5578,6955,0,12533
41.904613,-87.640552,6161,2213,2892,5361,121,8374
41.9053445,-87.6695198333333,0,1,1,0,0,1
41.9065251666667,-87.6350703333333,1,0,1,0,0,1
41.9065913333333,-87.6350911666667,1,0,1,0,0,1
41.9066328333333,-87.6352151666667,0,1,1,0,0,1
41.9066683333333,-87.6261593333333,0,1,1,0,0,1
41.906724,-87.63483,12616,9939,9799,12352,404,22555
41.906746864,-87.635144472,0,1,1,0,0,1
41.906866,-87.626217,8242,5479,5880,7546,295,13721
41.907066,-87.667252,7292,3791,4953,5942,188,11083
41.9070723333333,-87.667248,0,1,1,0,0,1
41.907221,-87.655618,1832,806,1344,1258,36,2638
41.907537699,-87.672519207,0,1,1,0,0,1
41.907560349,-87.67252779,0,1,1,0,0,1
41.9076186666667,-87.6383936666667,0,1,1,0,0,1
41.907626,-87.638566,2718,2129,1915,2841,91,4847
41.907655,-87.672552,10453,6478,7998,8556,377,16931
41.907688,-87.6385718333333,0,1,1,0,0,1
41.9077575,-87.6724971666667,0,1,1,0,0,1
41.9077608333333,-87.6860093333333,0,1,1,0,0,1
41.907781,-87.685854,1905,1252,1370,1731,56,3157
41.907993,-87.631501,13513,7710,8074,12737,412,21223
41.9080005,-87.6315456666667,1,0,1,0,0,1
41.908043623,-87.631488919,1,0,1,0,0,1
41.90925,-87.6776438333333,0,1,1,0,0,1
41.909396,-87.677692,0,724,0,0,724,724
41.9093960065,-87.6776919292,14269,10089,11655,12703,0,24358
41.9095753333333,-87.6481531666667,1,0,1,0,0,1
41.90965687563,-87.7166319516,758,860,871,747,0,1618
41.909657,-87.716632,0,86,0,0,86,86
41.909668,-87.648128,15993,7290,10300,12633,350,23283
41.909683824,-87.648195386,1,0,1,0,0,1
41.909718394,-87.648171544,0,1,1,0,0,1
41.909769,-87.70528,0,146,0,0,146,146
41.90976930169,-87.7052804871,2112,1671,2027,1756,0,3783
41.9098546521673,-87.6699301600456,5812,3746,4691,4867,0,9558
41.909855,-87.66993,0,177,0,0,177,177
41.909878,-87.6820488333333,1,0,1,0,0,1
41.91,-87.85,0,2,2,0,0,2
41.91,-87.83,0,1,1,0,0,1
41.91,-87.82,2,0,2,0,0,2
41.91,-87.81,70,106,176,0,0,176
41.91,-87.8,59,53,112,0,0,112
41.91,-87.79,35,50,85,0,0,85
41.91,-87.78,43,81,124,0,0,124
41.91,-87.77,60,247,307,0,0,307
41.91,-87.76,85,222,307,0,0,307
41.91,-87.75,107,349,456,0,0,456
41.91,-87.74,187,324,511,0,0,511
41.91,-87.73,350,644,994,0,0,994
41.91,-87.72,358,520,878,0,0,878
41.91,-87.71,1743,1057,2797,3,0,2800
41.91,-87.7,1679,1055,2734,0,0,2734
41.91,-87.69,1836,1526,3362,0,0,3362
41.91,-87.68,4137,3712,7847,2,0,7849
41.91,-87.67,2332,2077,4408,1,0,4409
41.91,-87.66,1175,912,2087,0,0,2087
41.91,-87.65,3701,1932,5633,0,0,5633
41.91,-87.64,1577,1188,2759,6,0,2765
41.91,-87.63,6243,6110,12314,39,0,12353
41.91,-87.62,1680,2185,3865,0,0,3865
41.91,-87.52,1,0,1,0,0,1
41.910135508,-87.682426572,1,0,1,0,0,1
41.910139799,-87.643470883,0,1,1,0,0,1
41.91021,-87.6435,4464,3112,3369,4127,80,7576
41.9102445,-87.643544,0,1,1,0,0,1
41.9102878333333,-87.6434843333333,0,1,1,0,0,1
41.91044,-87.6972,381,252,378,239,16,633
41.910475,-87.696894,0,117,0,0,117,117
41.9104754,-87.6968944,2959,2030,2550,2439,0,4989
41.910509,-87.682389,0,141,0,0,141,141
41.910509366664,-87.6823890209198,4500,2816,3531,3785,0,7316
41.910522,-87.653106,10834,5053,6726,8895,266,15887
41.9105316666667,-87.6532333333333,1,0,1,0,0,1
41.910535,-87.689556,4207,2975,3653,3424,105,7182
41.910578,-87.649422,0,228,0,0,228,228
41.9105780349,-87.6494219288,8721,4034,5710,7045,0,12755
41.9105978333333,-87.6895968333333,0,1,1,0,0,1
41.911366,-87.6385321666667,1,0,1,0,0,1
41.911366701,-87.638644218,1,0,1,0,0,1
41.911386,-87.638677,10683,6704,6129,10930,328,17387
41.9115695,-87.6266236666667,0,1,1,0,0,1
41.9116181666667,-87.6267003333333,0,1,1,0,0,1
41.911693931,-87.626755476,0,1,1,0,0,1
41.911714435,-87.626805782,0,1,1,0,0,1
41.911722,-87.626804,16677,26567,11867,28270,3107,43244
41.911726117,-87.626882792,1,0,1,0,0,1
41.9117548333333,-87.6268995,0,1,1,0,0,1
41.9117981666667,-87.6269011666667,0,1,1,0,0,1
41.9118076666667,-87.626936,0,1,1,0,0,1
41.9118778333333,-87.6320685,0,1,1,0,0,1
41.911974,-87.631942,7269,6586,4596,8571,688,13855
41.912133,-87.634656,24966,16400,17359,23316,691,41366
41.9121438333333,-87.6347408333333,0,1,1,0,0,1
41.9125468333333,-87.6813475,1,0,1,0,0,1
41.9126058333333,-87.6813346666667,0,1,1,0,0,1
41.912616,-87.681391,9144,5298,6809,7312,321,14442
41.912919,-87.664169,2340,1596,1661,2208,67,3936
41.913688,-87.652855,8355,4360,4803,7733,179,12715
41.913865,-87.648755,9357,3842,5737,7291,171,13199
41.91402671273,-87.705126462,3423,2030,3025,2428,0,5453
41.914027,-87.705126,0,160,0,0,160,160
41.9140535,-87.705157,0,1,1,0,0,1
41.914166,-87.716755,1970,1890,1384,2242,234,3860
41.91461,-87.667968,5652,2863,3101,5161,253,8515
41.91468,-87.64332,4499,1925,2180,4109,135,6424
41.91552,-87.687022,7045,4590,5508,5836,291,11635
41.9155565,-87.6870201666667,0,1,1,0,0,1
41.915689,-87.6346,14721,13991,10303,17347,1062,28712
41.9156946666667,-87.6870926666667,1,0,1,0,0,1
41.9157031666667,-87.6949188333333,1,0,1,0,0,1
41.9157435,-87.634645,0,1,1,0,0,1
41.915983,-87.677335,7589,6333,6376,7207,339,13922
41.916433,-87.666746,0,185,0,0,185,185
41.9164334291265,-87.666746377945,6501,3581,4897,5185,0,10082
41.9170878333333,-87.7104218333333,0,1,1,0,0,1
41.917108,-87.710221,0,208,0,0,208,208
41.9171080347893,-87.7102209627628,3493,2550,3412,2631,0,6043
41.9174711666667,-87.701815,1,0,1,0,0,1
41.917513,-87.701809,0,129,0,0,129,129
41.91751339399,-87.7018089555,3111,2696,3172,2635,0,5807
41.917525887,-87.701854587,1,0,1,0,0,1
41.9175511666667,-87.7017331666667,1,0,1,0,0,1
41.9175661666667,-87.7016338333333,1,0,1,0,0,1
41.917741,-87.691392,3364,2080,2886,2452,106,5444
41.917805,-87.682437,3726,2603,3117,3099,113,6329
41.917967081,-87.652105689,0,1,1,0,0,1
41.918018,-87.652183,13,8,7,14,0,21
41.918018,-87.652182,0,156,0,0,156,156
41.9180181423719,-87.6521819829941,4430,2347,2391,4386,0,6777
41.918077,-87.6363298333333,0,1,1,0,0,1
41.9180806666667,-87.6571115,0,1,1,0,0,1
41.918084,-87.643749,6437,3511,3701,6053,194,9948
41.918139,-87.643807,0,1,1,0,0,1
41.918216,-87.656936,7662,4058,4165,7376,179,11720
41.9182955629354,-87.6521833240986,8522,5512,4844,9190,0,14034
41.918296,-87.652183,0,160,0,0,160,160
41.918306,-87.636282,16792,14402,11893,18035,1266,31194
41.9183801666667,-87.6523035,0,1,1,0,0,1
41.9184605,-87.6520501666667,0,1,1,0,0,1
41.9184665,-87.652019,1,0,1,0,0,1
41.918468,-87.6522105,0,1,1,0,0,1
41.9184733333333,-87.6522235,0,1,1,0,0,1
41.9184895,-87.6523275,0,1,1,0,0,1
41.918491,-87.697423,0,84,0,0,84,84
41.918491153687,-87.6974228024483,3162,2205,2995,2372,0,5367
41.919936,-87.64883,11403,7081,8046,10159,279,18484
41.92,-87.81,20,24,44,0,0,44
41.92,-87.8,160,189,349,0,0,349
41.92,-87.79,159,236,395,0,0,395
41.92,-87.78,112,195,307,0,0,307
41.92,-87.77,328,474,802,0,0,802
41.92,-87.76,495,641,1136,0,0,1136
41.92,-87.75,469,970,1439,0,0,1439
41.92,-87.74,912,1003,1915,0,0,1915
41.92,-87.73,584,816,1399,1,0,1400
41.92,-87.72,1864,1368,3232,0,0,3232
41.92,-87.71,1324,1208,2532,0,0,2532
41.92,-87.7,3891,3627,7518,0,0,7518
41.92,-87.69,2870,2031,4900,1,0,4901
41.92,-87.68,1248,1177,2424,1,0,2425
41.92,-87.67,1718,1218,2936,0,0,2936
41.92,-87.66,2289,1580,3866,3,0,3869
41.92,-87.65,5567,4045,9607,5,0,9612
41.92,-87.64,3090,2413,5499,4,0,5503
41.92,-87.63,2357,3568,5925,0,0,5925
41.920042992,-87.677919745,0,1,1,0,0,1
41.920082,-87.677855,3725,3273,3452,3358,188,6998
41.9201955620057,-87.6926591992378,2907,2173,2513,2567,0,5080
41.920196,-87.692659,0,121,0,0,121,121
41.9203485,-87.6926343333333,0,1,1,0,0,1
41.920771,-87.663712,7649,4666,5315,6718,282,12315
41.9210567299276,-87.6727974414825,863,591,874,580,0,1454
41.921057,-87.672797,0,21,0,0,21,21
41.921525,-87.707322,2793,2213,2517,2351,138,5006
41.92154,-87.653818,12603,7409,8144,11563,305,20012
41.921694517,-87.653761387,1,0,1,0,0,1
41.921822,-87.64414,14078,10275,9431,14378,544,24353
41.922167,-87.638888,9955,5787,5774,9604,364,15742
41.92229259,-87.638996363,0,1,1,0,0,1
41.922682762,-87.697157621,0,1,1,0,0,1
41.922695,-87.697153,8024,6706,7847,6525,358,14730
41.923931,-87.635825,0,1176,0,0,1176,1176
41.9239313113662,-87.6358245313168,5784,6077,3980,7881,0,11861
41.92409085038,-87.6764600747,3094,1371,2260,2205,0,4465
41.924091,-87.67646,0,78,0,0,78,78
41.924161,-87.64638,0,342,0,0,342,342
41.9241610290676,-87.6463803648949,14462,8704,10024,13142,0,23166
41.9241795,-87.6359033333333,1,0,1,0,0,1
41.9243006666667,-87.6464055,1,0,1,0,0,1
41.92459,-87.72785,704,875,782,739,58,1579
41.924632,-87.689307,0,100,0,0,100,100
41.92463247165,-87.6893070063,2118,1759,2040,1837,0,3877
41.9248155968119,-87.714495062828,2457,1625,1987,2095,0,4082
41.924816,-87.714495,0,146,0,0,146,146
41.925194,-87.657259,0,84,0,0,84,84
41.925194265177,-87.657258734107,2692,901,1611,1982,0,3593
41.92533,-87.6658,9245,5883,6642,8216,270,15128
41.925378919,-87.665867329,0,1,1,0,0,1
41.925485,-87.6536883333333,0,1,1,0,0,1
41.925514,-87.658399,0,39,0,0,39,39
41.9255366666667,-87.6658196666667,1,0,1,0,0,1
41.92556258,-87.65840426,9299,3588,4472,8415,0,12887
41.925563,-87.658404,0,204,0,0,204,204
41.925566,-87.658416,1827,343,983,1187,0,2170
41.9255976666667,-87.6583256666667,0,1,1,0,0,1
41.9256018819,-87.6537080423,18292,8220,11130,15382,0,26512
41.925602,-87.653708,0,502,0,0,502,502
41.9257066666667,-87.6585823333333,0,1,1,0,0,1
41.9257536666667,-87.6391676666667,0,1,1,0,0,1
41.925858,-87.638973,13659,10322,8975,14300,706,23981
41.9260488333333,-87.6386538333333,0,1,1,0,0,1
41.9262035,-87.6312178333333,0,1,1,0,0,1
41.926277,-87.630834,14279,19842,8307,23017,2797,34121
41.92669,-87.697668,2818,1791,2111,2379,119,4609
41.9267559875,-87.6344287848,2756,3317,1810,4263,0,6073
41.926756,-87.634429,0,875,0,0,875,875
41.9268076666667,-87.6344951666667,0,1,1,0,0,1
41.9271495,-87.6500673333333,1,0,1,0,0,1
41.9286411666667,-87.6637991666667,0,1,1,0,0,1
41.9286481666667,-87.6538003333333,0,1,1,0,0,1
41.928712,-87.653833,10780,7863,7226,11104,313,18643
41.928773,-87.663913,7524,6136,6004,7479,177,13660
41.928785801,-87.663906574,0,1,1,0,0,1
41.92883,-87.668507,4063,3194,3127,3911,219,7257
41.928887,-87.658971,5224,3489,3177,5416,120,8713
41.9291121666667,-87.6490276666667,0,1,1,0,0,1
41.929143,-87.649077,14181,8620,9042,13413,346,22801
41.9291536666667,-87.6491328333333,0,1,1,0,0,1
41.9292211666667,-87.6637711666667,1,0,1,0,0,1
41.9293603333333,-87.6840966666667,0,1,1,0,0,1
41.9294308333333,-87.6841998333333,0,1,1,0,0,1
41.9294503333333,-87.6430165,0,1,1,0,0,1
41.929465,-87.684158,4777,3103,4068,3643,169,7880
41.9295191666667,-87.7079003333333,0,1,1,0,0,1
41.9295386666667,-87.7078238333333,0,1,1,0,0,1
41.929546,-87.643118,17348,11106,11473,16470,511,28454
41.929554,-87.7078631666667,1,0,1,0,0,1
41.929567,-87.707857,9295,7686,9501,6948,532,16981
41.9296186666667,-87.7079703333333,0,1,1,0,0,1
41.92963,-87.7080885,0,1,1,0,0,1
41.9296676666667,-87.6431445,0,1,1,0,0,1
41.9296823333333,-87.7081351666667,0,1,1,0,0,1
41.929686069,-87.708030105,0,1,1,0,0,1
41.929712,-87.7081421666667,1,0,1,0,0,1
41.93,-87.83,1,3,4,0,0,4
41.93,-87.82,3,5,8,0,0,8
41.93,-87.81,97,108,205,0,0,205
41.93,-87.8,269,556,825,0,0,825
41.93,-87.79,688,952,1640,0,0,1640
41.93,-87.78,475,575,1050,0,0,1050
41.93,-87.77,472,441,913,0,0,913
41.93,-87.76,868,536,1404,0,0,1404
41.93,-87.75,516,421,937,0,0,937
41.93,-87.74,709,892,1601,0,0,1601
41.93,-87.73,749,553,1302,0,0,1302
41.93,-87.72,1470,1050,2520,0,0,2520
41.93,-87.71,3021,2290,5310,1,0,5311
41.93,-87.7,1672,1385,3057,0,0,3057
41.93,-87.69,2045,1851,3896,0,0,3896
41.93,-87.68,1657,1007,2664,0,0,2664
41.93,-87.67,1810,1318,3124,4,0,3128
41.93,-87.66,2912,2156,5058,10,0,5068
41.93,-87.65,5399,3767,9164,2,0,9166
41.93,-87.64,7729,5345,13072,2,0,13074
41.93,-87.63,862,1927,2789,0,0,2789
41.930585,-87.723777,0,95,0,0,95,95
41.93058537138,-87.7237773635,1891,1446,1914,1423,0,3337
41.930791259,-87.643880248,1,0,1,0,0,1
41.9312371666667,-87.644067,1,0,1,0,0,1
41.931248,-87.644336,16215,8922,8872,15769,496,25137
41.93132,-87.638742,10537,7339,6468,10828,580,17876
41.93133378,-87.638761282,0,1,1,0,0,1
41.93190196886,-87.7011951301,2205,1562,1973,1794,0,3767
41.931902,-87.701195,0,67,0,0,67,67
41.9319206666667,-87.67783,0,1,1,0,0,1
41.931931,-87.677856,3566,1945,2620,2781,110,5511
41.9319788333333,-87.6588301666667,0,1,1,0,0,1
41.9320456666667,-87.6587493333333,1,0,1,0,0,1
41.9321311666667,-87.6586938333333,1,0,1,0,0,1
41.932225,-87.658617,11156,5951,7331,9559,217,17107
41.9322901666667,-87.6526955,0,1,1,0,0,1
41.932418,-87.652705,13908,7617,8835,12412,278,21525
41.9324443333333,-87.6527181666667,0,1,1,0,0,1
41.932451,-87.6527575,0,1,1,0,0,1
41.9324511666667,-87.6527491666667,0,1,1,0,0,1
41.932482,-87.6527533333333,0,1,1,0,0,1
41.9325221666667,-87.6364376666667,0,1,1,0,0,1
41.932588,-87.636427,12757,10591,8205,14239,904,23348
41.9325896342979,-87.6659363508224,4396,3122,3243,4275,0,7518
41.93259,-87.665936,0,173,0,0,173,173
41.9327158333333,-87.6659453333333,0,1,1,0,0,1
41.933055282,-87.64778924,0,1,1,0,0,1
41.93314,-87.64776,10884,5637,5899,10411,211,16521
41.9335721666667,-87.6457323333333,0,1,1,0,0,1
41.935337,-87.716889,0,73,0,0,73,73
41.93533728263,-87.7168892935,1914,1586,2309,1191,0,3500
41.935733,-87.663576,6270,4216,3948,6340,198,10486
41.9357746176646,-87.6636001467705,2729,1207,2020,1916,0,3936
41.935775,-87.6636,0,56,0,0,56,56
41.93588,-87.67842,3044,2732,2768,2890,118,5776
41.9359248333333,-87.6783813333333,0,1,1,0,0,1
41.936083,-87.669807,5294,2448,3424,4197,121,7742
41.9361075,-87.6699178333333,1,0,1,0,0,1
41.936253,-87.652662,0,279,0,0,279,279
41.9362534831413,-87.6526620984077,12262,7371,8100,11533,0,19633
41.936257,-87.652551,0,1,1,0,0,1
41.9364968219,-87.6475386582,11848,7089,7284,11653,0,18937
41.936497,-87.647539,0,347,0,0,347,347
41.936524,-87.6475693333333,0,1,1,0,0,1
41.936688,-87.636829,0,793,0,0,793,793
41.9366884494997,-87.6368290185928,11579,8683,6986,13276,0,20262
41.936716,-87.6368235,0,1,1,0,0,1
41.9368,-87.6368263333333,0,1,1,0,0,1
41.9374881666667,-87.6443196666667,1,0,1,0,0,1
41.9375776666667,-87.6440916666667,0,1,1,0,0,1
41.937582,-87.644098,0,572,0,0,572,572
41.9375823160063,-87.6440978050232,20576,12217,13245,19548,0,32793
41.93842879148,-87.698007756,2354,2155,2196,2313,0,4509
41.938429,-87.698008,0,154,0,0,154,154
41.9393298333333,-87.683318,0,1,1,0,0,1
41.939337,-87.6710611666667,0,1,1,0,0,1
41.939354,-87.683282,2860,2399,3014,2113,132,5259
41.939365,-87.668385,2206,849,1224,1784,47,3055
41.939393953443,-87.7120676636696,279,149,262,166,0,428
41.939394,-87.712068,0,6,0,0,6,6
41.939398,-87.711561,1246,1087,1316,952,65,2333
41.939408,-87.723574,1445,1442,1691,1095,101,2887
41.9394296666667,-87.7235506666667,1,0,1,0,0,1
41.9394453333333,-87.683271,0,1,1,0,0,1
41.9394777504051,-87.6637476682663,8408,4787,5616,7579,0,13195
41.939478,-87.663748,0,191,0,0,191,191
41.9395316198226,-87.6711143553257,4499,2514,3119,3894,0,7013
41.939532,-87.671114,0,112,0,0,112,112
41.9396338333333,-87.6588288333333,1,0,1,0,0,1
41.939667344,-87.658908248,0,1,1,0,0,1
41.939743,-87.658865,9031,6842,6877,8763,233,15873
41.9398148333333,-87.6589308333333,1,0,1,0,0,1
41.94,-87.88,0,1,1,0,0,1
41.94,-87.83,136,48,184,0,0,184
41.94,-87.82,195,184,379,0,0,379
41.94,-87.81,68,229,297,0,0,297
41.94,-87.8,56,208,264,0,0,264
41.94,-87.79,330,309,639,0,0,639
41.94,-87.78,128,223,351,0,0,351
41.94,-87.77,431,437,868,0,0,868
41.94,-87.76,297,495,792,0,0,792
41.94,-87.75,734,654,1388,0,0,1388
41.94,-87.74,354,474,828,0,0,828
41.94,-87.73,799,637,1436,0,0,1436
41.94,-87.72,626,872,1498,0,0,1498
41.94,-87.71,1101,963,2064,0,0,2064
41.94,-87.7,1159,985,2144,0,0,2144
41.94,-87.69,1934,1661,3594,1,0,3595
41.94,-87.68,910,900,1810,0,0,1810
41.94,-87.67,3228,2123,5343,8,0,5351
41.94,-87.66,3001,2449,5437,13,0,5450
41.94,-87.65,6639,5449,12062,26,0,12088
41.94,-87.64,5739,4984,10719,4,0,10723
41.94,-87.63,445,528,973,0,0,973
41.940106,-87.645451,11224,7303,6874,11132,521,18527
41.94018,-87.65304,9258,6452,5971,9449,290,15710
41.9402319181086,-87.6529437303543,9118,4835,6482,7471,0,13953
41.940232,-87.652944,0,165,0,0,165,165
41.9405253333333,-87.6783501666667,1,0,1,0,0,1
41.9406,-87.6785,2380,2025,1986,2286,133,4405
41.9406861666667,-87.6391673333333,0,1,1,0,0,1
41.9406968333333,-87.6391866666667,0,1,1,0,0,1
41.9407088333333,-87.6392365,0,1,1,0,0,1
41.940769553,-87.639092803,0,1,1,0,0,1
41.940775,-87.639192,11303,10906,8242,13071,896,22209
41.9430048333333,-87.6494133333333,0,1,1,0,0,1
41.943034,-87.687288,2867,1371,2027,2140,71,4238
41.9433005,-87.6707871666667,0,1,1,0,0,1
41.9433221666667,-87.6706943333333,0,1,1,0,0,1
41.9433241666667,-87.6707398333333,0,1,1,0,0,1
41.94335,-87.670668,0,100,0,0,100,100
41.9433502470174,-87.6706677675247,5468,3028,3299,5197,0,8496
41.9433523333333,-87.6709066666667,1,0,1,0,0,1
41.943403,-87.679618,4638,2857,3881,3499,115,7495
41.943445444,-87.670936942,0,1,1,0,0,1
41.9434631666667,-87.6639431666667,0,1,1,0,0,1
41.9436648333333,-87.6489305,0,1,1,0,0,1
41.94367,-87.64895,13865,10545,11738,12211,461,24410
41.943739,-87.66402,14066,8861,8882,13659,386,22927
41.9437598333333,-87.64891,0,1,1,0,0,1
41.943785,-87.671251,0,58,0,0,58,58
41.9437851649707,-87.6712511479855,1433,842,877,1398,0,2275
41.943791,-87.671258,0,26,0,0,26,26
41.9437911500595,-87.671257853508,918,259,436,741,0,1177
41.9437912,-87.6712579,3,0,2,1,0,3
41.944019,-87.663975,0,1,1,0,0,1
41.9444526666667,-87.6547513333333,0,1,1,0,0,1
41.94449,-87.654595,0,1,1,0,0,1
41.94454,-87.654678,12951,12747,11120,14016,562,25698
41.9445531666667,-87.6547286666667,1,0,1,0,0,1
41.94524356848,-87.7066499009,1701,1212,1375,1538,0,2913
41.945244,-87.70665,0,96,0,0,96,96
41.9452653333333,-87.7067043333333,1,0,1,0,0,1
41.945515871,-87.646401644,1,0,1,0,0,1
41.945529,-87.646439,14610,8655,9157,13675,433,23265
41.9461053333333,-87.6732788333333,0,1,1,0,0,1
41.946176,-87.673308,2576,1761,1788,2464,85,4337
41.946264,-87.731023,360,463,403,377,43,823
41.9466358306,-87.694614758,2685,1468,2283,1870,0,4153
41.946636,-87.694615,0,81,0,0,81,81
41.946655,-87.683359,2305,1384,1620,2009,60,3689
41.9470708941847,-87.7400082349777,298,207,262,243,0,505
41.947071,-87.740008,0,19,0,0,19,19
41.947326,-87.717582,1096,701,1124,638,35,1797
41.9474196666667,-87.717607,0,1,1,0,0,1
41.9474236666667,-87.717624,1,0,1,0,0,1
41.9480543333333,-87.6640193333333,0,1,1,0,0,1
41.94815,-87.66394,13195,8113,8845,12101,362,21308
41.948187,-87.6639828333333,1,0,1,0,0,1
41.9487333333333,-87.675184,0,1,1,0,0,1
41.948797,-87.675278,3513,1972,2269,3124,92,5485
41.949041,-87.6486286666667,0,1,1,0,0,1
41.9490595,-87.6485375,0,1,1,0,0,1
41.949074,-87.648636,16375,8108,10057,14040,386,24483
41.949093,-87.6464156666667,0,1,1,0,0,1
41.94927299,-87.646373391,0,1,1,0,0,1
41.949399,-87.654529,12683,12194,10686,13177,1014,24877
41.9494038333333,-87.6464103333333,0,1,1,0,0,1
41.9494727408833,-87.6464527845383,13248,7667,7949,12966,0,20915
41.949473,-87.646453,0,446,0,0,446,446
41.949923,-87.713949,1773,669,1642,765,35,2442
41.95,-87.87,0,1,1,0,0,1
41.95,-87.84,1,9,10,0,0,10
41.95,-87.83,31,124,155,0,0,155
41.95,-87.82,10,36,46,0,0,46
41.95,-87.81,227,683,910,0,0,910
41.95,-87.8,24,60,84,0,0,84
41.95,-87.79,422,298,720,0,0,720
41.95,-87.78,96,215,311,0,0,311
41.95,-87.77,104,188,292,0,0,292
41.95,-87.76,556,831,1387,0,0,1387
41.95,-87.75,224,447,671,0,0,671
41.95,-87.74,245,249,494,0,0,494
41.95,-87.73,384,470,854,0,0,854
41.95,-87.72,640,428,1068,0,0,1068
41.95,-87.71,1437,1410,2847,0,0,2847
41.95,-87.7,1085,1254,2339,0,0,2339
41.95,-87.69,2136,1535,3670,1,0,3671
41.95,-87.68,1030,883,1913,0,0,1913
41.95,-87.67,1264,1137,2400,1,0,2401
41.95,-87.66,4292,4253,8541,4,0,8545
41.95,-87.65,4596,3597,8184,9,0,8193
41.95,-87.64,1575,1442,3017,0,0,3017
41.9506365,-87.6687038333333,1,0,1,0,0,1
41.950682521,-87.66876483,1,0,1,0,0,1
41.950687,-87.6687,4616,3408,3673,4186,165,8024
41.9507185,-87.6591421666667,0,1,1,0,0,1
41.95078,-87.659172,8455,6415,6539,8024,307,14870
41.950845957,-87.659198523,0,1,1,0,0,1
41.950892,-87.6591913333333,0,1,1,0,0,1
41.952162,-87.698051,0,106,0,0,106,106
41.95216219326,-87.698051113,1695,1125,1479,1341,0,2820
41.9526821666667,-87.6502201666667,0,1,1,0,0,1
41.9527091666667,-87.6499456666667,1,0,1,0,0,1
41.952833,-87.649993,11004,5836,7351,9235,254,16840
41.9528778333333,-87.6500123333333,0,1,1,0,0,1
41.953393,-87.732002,1256,1028,1535,700,49,2284
41.953586,-87.709311,0,54,0,0,54,54
41.95358617895,-87.7093107999,725,561,744,542,0,1286
41.953733,-87.740569,315,263,326,231,21,578
41.9537365,-87.740539,0,1,1,0,0,1
41.9539786666667,-87.7190776666667,0,1,1,0,0,1
41.954001069,-87.719119549,1,0,1,0,0,1
41.95400483876,-87.7191281797,1041,812,1123,730,0,1853
41.954005,-87.719128,0,62,0,0,62,62
41.954177,-87.664358,6116,2954,3645,5290,135,9070
41.954219,-87.6544563333333,1,0,1,0,0,1
41.9542441666667,-87.6545635,0,1,1,0,0,1
41.954245,-87.654406,13435,6518,8205,11448,300,19953
41.95434085219,-87.6860796243,1988,983,1084,1887,0,2971
41.954341,-87.68608,0,104,0,0,104,104
41.954345,-87.6481178333333,1,0,1,0,0,1
41.9543531666667,-87.6481973333333,0,1,1,0,0,1
41.954383,-87.648043,10751,6199,7045,9470,435,16950
41.954426885,-87.648038268,0,1,1,0,0,1
41.954468,-87.749594,470,503,571,360,42,973
41.9544823333333,-87.7496968333333,0,1,1,0,0,1
41.95469,-87.67393,4398,2287,3048,3505,132,6685
41.9560035507855,-87.6801614463329,4583,2296,3180,3699,0,6879
41.956004,-87.680161,0,125,0,0,125,125
41.956057,-87.668835,1904,1885,1822,1905,62,3789
41.957081,-87.664199,2116,1219,1223,2039,73,3335
41.9570831666667,-87.6641731666667,1,0,1,0,0,1
41.957761168,-87.649413109,0,1,1,0,0,1
41.9578143333333,-87.6496421666667,0,1,1,0,0,1
41.9578665241517,-87.6495051383972,10770,4115,6706,8179,0,14885
41.957867,-87.649505,0,254,0,0,254,254
41.9578736666667,-87.673456,1,0,1,0,0,1
41.957921,-87.673567,3266,1516,2065,2623,94,4782
41.9584396666667,-87.6548316666667,1,0,1,0,0,1
41.958494,-87.654966,7328,3153,4531,5797,153,10481
41.96,-87.92,0,1,1,0,0,1
41.96,-87.82,1,2,3,0,0,3
41.96,-87.81,5,23,28,0,0,28
41.96,-87.8,2,8,10,0,0,10
41.96,-87.79,22,15,37,0,0,37
41.96,-87.78,5,6,11,0,0,11
41.96,-87.77,12,23,35,0,0,35
41.96,-87.76,74,46,120,0,0,120
41.96,-87.75,176,184,360,0,0,360
41.96,-87.74,187,159,346,0,0,346
41.96,-87.73,311,295,606,0,0,606
41.96,-87.72,624,517,1141,0,0,1141
41.96,-87.71,982,539,1521,0,0,1521
41.96,-87.7,1580,1035,2615,0,0,2615
41.96,-87.69,1168,825,1993,0,0,1993
41.96,-87.68,1059,912,1971,0,0,1971
41.96,-87.67,919,705,1618,6,0,1624
41.96,-87.66,1154,714,1867,1,0,1868
41.96,-87.65,2628,1622,4245,5,0,4250
41.96,-87.64,872,1500,2372,0,0,2372
41.96,-87.63,396,388,784,0,0,784
41.960631,-87.745359,782,604,823,495,68,1386
41.9609948333333,-87.7057761666667,1,0,1,0,0,1
41.9609985,-87.6494873333333,0,1,1,0,0,1
41.961004,-87.649603,8854,4493,6261,6768,318,13347
41.9610296666667,-87.6496768333333,1,0,1,0,0,1
41.961036,-87.6495431666667,0,1,1,0,0,1
41.961041,-87.705866,1697,884,1354,1128,99,2581
41.961053,-87.6954473333333,0,1,1,0,0,1
41.961068,-87.695439,2488,1420,1673,2032,203,3908
41.96108,-87.73569,607,351,429,493,36,958
41.961108,-87.72897,0,76,0,0,76,76
41.96110801623,-87.7289701012,839,472,813,498,0,1311
41.961154,-87.716569,0,52,0,0,52,52
41.96115407569,-87.7165690733,1041,664,840,865,0,1705
41.961406,-87.676169,4053,2425,3180,3187,111,6478
41.9614258333333,-87.6546813333333,0,1,1,0,0,1
41.9614836086673,-87.692321240902,72,27,54,45,0,99
41.961484,-87.692321,0,13,0,0,13,13
41.961507,-87.671387,3172,1480,2187,2381,84,4652
41.961524,-87.691177,429,83,209,303,0,512
41.96152593287,-87.6911650414,2327,796,1572,1551,0,3123
41.961526,-87.691165,0,69,0,0,69,69
41.9615301666667,-87.6546558333333,0,1,1,0,0,1
41.9615418333333,-87.6662046666667,1,0,1,0,0,1
41.961562634,-87.666340947,0,1,1,0,0,1
41.961572,-87.693536,0,3,0,0,3,3
41.9615723627785,-87.6935362815857,82,23,42,63,0,105
41.961588,-87.666036,4537,2760,3596,3571,130,7297
41.96167,-87.65464,11007,5803,7451,8981,378,16810
41.963004,-87.684781,4434,2520,3211,3590,153,6954
41.963235,-87.6793511666667,1,0,1,0,0,1
41.96325,-87.679258,2770,1445,1717,2407,91,4215
41.9639168333333,-87.6382206666667,0,1,1,0,0,1
41.963982,-87.638181,8043,12424,6573,11795,2099,20467
41.9639935,-87.6382176666667,0,1,1,0,0,1
41.9640196666667,-87.6382476666667,0,1,1,0,0,1
41.9649586666667,-87.6739033333333,1,0,1,0,0,1
41.9651666666667,-87.6582216666667,0,1,1,0,0,1
41.965221,-87.658139,8568,4556,6176,6684,264,13124
41.965845,-87.645361,4636,4414,2555,5821,674,9050
41.965866,-87.6455418333333,1,0,1,0,0,1
41.965875,-87.700825,1725,700,1328,1035,62,2425
41.9659,-87.693638,0,74,0,0,74,74
41.96590013976,-87.6936384935,2908,1172,2226,1854,0,4080
41.966399801841,-87.6887042820454,6322,2993,4981,4334,0,9315
41.9664,-87.688704,0,193,0,0,193,193
41.966686,-87.708052,0,102,0,0,102,102
41.96668636205,-87.7080519806,1332,731,1192,871,0,2063
41.967056,-87.66699,0,45,0,0,45,45
41.9670564289456,-87.6669904589653,1475,790,1078,1187,0,2265
41.9670878391842,-87.667290866375,1999,603,1208,1394,0,2602
41.967088,-87.667291,0,37,0,0,37,37
41.967094,-87.679028,4245,1977,3178,2938,106,6222
41.967096,-87.667429,3790,2025,2359,3353,103,5815
41.967130184,-87.667544246,0,1,1,0,0,1
41.9671525,-87.678967,0,1,1,0,0,1
41.967968,-87.650001,5358,2957,3956,4088,271,8315
41.968354,-87.711831,0,86,0,0,86,86
41.96835449363,-87.7118306675,1558,934,1614,878,0,2492
41.968812,-87.657659,4635,2973,3539,3908,161,7608
41.968885,-87.684001,2093,1137,1607,1548,75,3230
41.968987,-87.696027,2446,1115,1834,1672,55,3561
41.9690796666667,-87.6742038333333,1,0,1,0,0,1
41.96909,-87.674237,12900,5324,9717,8298,209,18224
41.969517,-87.654691,4889,2725,3462,3997,155,7614
41.97,-87.84,1,1,2,0,0,2
41.97,-87.83,0,1,1,0,0,1
41.97,-87.81,2,9,11,0,0,11
41.97,-87.79,0,3,3,0,0,3
41.97,-87.78,0,5,5,0,0,5
41.97,-87.77,4,6,10,0,0,10
41.97,-87.76,139,133,272,0,0,272
41.97,-87.75,68,25,93,0,0,93
41.97,-87.74,223,271,494,0,0,494
41.97,-87.73,102,161,263,0,0,263
41.97,-87.72,166,201,367,0,0,367
41.97,-87.71,576,560,1136,0,0,1136
41.97,-87.7,1739,1008,2746,1,0,2747
41.97,-87.69,1784,1271,3052,3,0,3055
41.97,-87.68,797,699,1496,0,0,1496
41.97,-87.67,1845,1440,3283,2,0,3285
41.97,-87.66,1917,1256,3172,1,0,3173
41.97,-87.65,1286,998,2282,2,0,2284
41.97,-87.64,226,522,748,0,0,748
41.97,-87.63,4,8,12,0,0,12
41.9716,-87.650154,4748,3662,3682,4321,407,8410
41.9732868202598,-87.6547595858574,2534,1487,2103,1918,0,4021
41.973287,-87.65476,0,118,0,0,118,118
41.973347640473,-87.6678554713726,10744,6273,9013,8004,0,17017
41.973348,-87.667855,0,312,0,0,312,312
41.973359,-87.6677883333333,0,1,1,0,0,1
41.973389,-87.6677673333333,0,1,1,0,0,1
41.973791957,-87.659678817,0,1,1,0,0,1
41.973815,-87.65966,6385,3326,3956,5504,251,9711
41.974911,-87.692503,0,71,0,0,71,71
41.97491129677,-87.6925025594,2065,1091,1918,1238,0,3156
41.9749121666667,-87.6926481666667,1,0,1,0,0,1
41.9755553333333,-87.6794991666667,0,1,1,0,0,1
41.97561480459,-87.6794590387,3335,2007,2959,2383,0,5342
41.975615,-87.679459,0,99,0,0,99,99
41.97563272521,-87.7014194389,1932,763,1241,1454,0,2695
41.975633,-87.701419,0,92,0,0,92,92
41.975672,-87.709261,745,664,732,593,84,1409
41.975921,-87.710415,1,0,1,0,0,1
41.9779696666667,-87.668171,1,0,1,0,0,1
41.9780306224866,-87.668564915657,8411,4760,6498,6673,0,13171
41.978031,-87.668565,0,307,0,0,307,307
41.978353,-87.659753,6476,3034,4269,5001,240,9510
41.979762,-87.67753,1892,898,1430,1308,52,2790
41.979851,-87.681932,2067,991,2017,990,51,3058
41.9798598333333,-87.6819838333333,0,1,1,0,0,1
41.98,-87.86,0,1,1,0,0,1
41.98,-87.84,2,2,4,0,0,4
41.98,-87.82,8,0,8,0,0,8
41.98,-87.81,2,1,3,0,0,3
41.98,-87.8,0,3,3,0,0,3
41.98,-87.79,0,1,1,0,0,1
41.98,-87.78,0,5,5,0,0,5
41.98,-87.77,3,3,6,0,0,6
41.98,-87.76,11,16,27,0,0,27
41.98,-87.75,4,6,10,0,0,10
41.98,-87.74,6,13,19,0,0,19
41.98,-87.73,8,9,17,0,0,17
41.98,-87.72,17,24,41,0,0,41
41.98,-87.71,282,300,582,0,0,582
41.98,-87.7,553,389,941,1,0,942
41.98,-87.69,1212,699,1911,0,0,1911
41.98,-87.68,349,290,638,1,0,639
41.98,-87.67,2332,1371,3693,10,0,3703
41.98,-87.66,1720,883,2600,3,0,2603
41.98,-87.65,1209,1138,2347,0,0,2347
41.980218,-87.7161335,0,1,1,0,0,1
41.980394,-87.716115,0,56,0,0,56,56
41.98039423475,-87.7161149615,683,367,570,480,0,1050
41.9822297591152,-87.7088865637779,755,472,592,635,0,1227
41.98223,-87.708887,0,66,0,0,66,66
41.983593,-87.669154,6640,3704,5339,4820,185,10344
41.983607,-87.6691963333333,0,1,1,0,0,1
41.983633518,-87.696412802,0,1,1,0,0,1
41.98366470886,-87.6964225611,645,526,615,556,0,1171
41.983665,-87.696423,0,42,0,0,42,42
41.9839906666667,-87.6523711666667,0,1,1,0,0,1
41.98403669612,-87.6523104689,175,23,27,171,0,198
41.984044,-87.652281,0,746,0,0,746,746
41.9840441151921,-87.6522812247276,7790,5802,4890,8702,0,13592
41.9840446107,-87.6602738295,5847,2491,4115,4223,0,8338
41.984045,-87.660274,0,166,0,0,166,166
41.98974251144,-87.6601406209,5467,2882,3727,4622,0,8349
41.989743,-87.660141,0,328,0,0,328,328
41.99,-87.86,0,1,1,0,0,1
41.99,-87.82,7,0,7,0,0,7
41.99,-87.8,3,0,3,0,0,3
41.99,-87.79,0,1,1,0,0,1
41.99,-87.78,2,5,7,0,0,7
41.99,-87.77,1,0,1,0,0,1
41.99,-87.76,2,3,5,0,0,5
41.99,-87.75,1,1,2,0,0,2
41.99,-87.73,4,16,20,0,0,20
41.99,-87.72,9,16,25,0,0,25
41.99,-87.71,511,500,1011,0,0,1011
41.99,-87.7,534,488,1022,0,0,1022
41.99,-87.69,241,339,580,0,0,580
41.99,-87.68,346,114,460,0,0,460
41.99,-87.67,1299,658,1957,0,0,1957
41.99,-87.66,1628,768,2395,1,0,2396
41.99,-87.65,324,303,627,0,0,627
41.990236,-87.69337,0,55,0,0,55,55
41.99023602867,-87.6933696402,485,363,323,525,0,848
41.99086,-87.669724,0,120,0,0,120,120
41.9908604481256,-87.6697236299515,2601,1398,1797,2202,0,3999
41.9908973333333,-87.6689555,0,1,1,0,0,1
41.991178,-87.683593,728,465,679,476,38,1193
41.994161,-87.689438,0,99,0,0,99,99
41.99416136902,-87.689438282,1040,568,802,806,0,1608
41.9947796884,-87.6602845349,5287,2794,3574,4507,0,8081
41.99478,-87.660285,0,415,0,0,415,415
41.999238,-87.6712813333333,0,1,1,0,0,1
41.9992465,-87.6714231666667,0,1,1,0,0,1
41.99925182186,-87.6713773393,2583,1221,2025,1779,0,3804
41.999252,-87.671377,0,73,0,0,73,73
42,-87.83,17,0,17,0,0,17
42,-87.82,11,3,14,0,0,14
42,-87.81,3,5,8,0,0,8
42,-87.79,1,7,8,0,0,8
42,-87.77,1,0,1,0,0,1
42,-87.76,1,2,3,0,0,3
42,-87.75,0,1,1,0,0,1
42,-87.74,1,1,2,0,0,2
42,-87.73,2,2,4,0,0,4
42,-87.72,13,13,26,0,0,26
42,-87.71,224,133,357,0,0,357
42,-87.7,534,428,962,0,0,962
42,-87.69,386,222,608,0,0,608
42,-87.68,345,162,507,0,0,507
42,-87.67,678,524,1202,0,0,1202
42,-87.66,706,474,1179,1,0,1180
42,-87.65,19,14,33,0,0,33
42.00104377979,-87.6611982433,3093,2041,2363,2771,0,5134
42.001044,-87.661198,0,214,0,0,214,214
42.0011795,-87.661348,1,0,1,0,0,1
42.001785,-87.688829,803,634,556,752,129,1437
42.00445062934,-87.6724024047,1927,943,1674,1196,0,2870
42.004451,-87.672402,0,62,0,0,62,62
42.00454962194,-87.6806661451,786,424,769,441,0,1210
42.00455,-87.680666,0,47,0,0,47,47
42.004583,-87.661406,2723,1451,2042,1980,152,4174
42.00797192287,-87.6655023944,3541,1694,2681,2554,0,5235
42.007972,-87.665502,0,134,0,0,134,134
42.008585,-87.6904613333333,0,1,1,0,0,1
42.008594,-87.690492,0,69,0,0,69,69
42.0085943972,-87.6904922389,1326,501,907,920,0,1827
42.009011,-87.674112,0,82,0,0,82,82
42.0090111805808,-87.6741117238998,2628,1141,2285,1484,0,3769
42.01,-87.83,1,0,1,0,0,1
42.01,-87.82,0,1,1,0,0,1
42.01,-87.81,0,2,2,0,0,2
42.01,-87.8,1,0,1,0,0,1
42.01,-87.78,0,1,1,0,0,1
42.01,-87.77,0,4,4,0,0,4
42.01,-87.76,1,2,3,0,0,3
42.01,-87.75,1,1,2,0,0,2
42.01,-87.74,2,4,6,0,0,6
42.01,-87.73,3,0,3,0,0,3
42.01,-87.72,9,16,25,0,0,25
42.01,-87.71,169,222,391,0,0,391
42.01,-87.7,265,288,553,0,0,553
42.01,-87.69,337,209,545,1,0,546
42.01,-87.68,320,311,631,0,0,631
42.01,-87.67,537,459,994,2,0,996
42.01,-87.66,445,224,669,0,0,669
42.01058656284,-87.6624120948,1246,921,949,1218,0,2167
42.010587,-87.662412,0,191,0,0,191,191
42.012132,-87.682913,0,29,0,0,29,29
42.01213227742,-87.6829126443,473,384,443,414,0,857
42.012342,-87.688243,418,336,362,363,29,754
42.01256,-87.674367,0,70,0,0,70,70
42.01256011541,-87.6743671152,614,516,585,545,0,1130
42.012701,-87.666058,1654,672,755,1499,72,2326
42.015962,-87.66857,2641,1191,1570,2192,70,3832
42.015963,-87.675005,866,320,455,698,33,1186
42.016977,-87.677725,403,200,407,180,16,603
42.018901,-87.690048,914,528,719,696,27,1442
42.019159,-87.673573,1995,950,1311,1585,49,2945
42.0192025019323,-87.6643028855324,353,185,278,260,0,538
42.019203,-87.664303,0,4,0,0,4,4
42.019276,-87.68452,528,327,421,407,27,855
42.019537,-87.669563,739,298,468,543,26,1037
42.02,-87.83,0,2,2,0,0,2
42.02,-87.75,0,3,3,0,0,3
42.02,-87.73,0,1,1,0,0,1
42.02,-87.72,0,7,7,0,0,7
42.02,-87.71,228,104,332,0,0,332
42.02,-87.7,50,84,134,0,0,134
42.02,-87.69,211,167,378,0,0,378
42.02,-87.68,277,192,468,1,0,469
42.02,-87.67,258,212,468,2,0,470
42.02,-87.66,40,25,65,0,0,65
42.020887,-87.665058,0,95,0,0,95,95
42.0208872805206,-87.6650579273701,1129,630,797,962,0,1759
42.023463,-87.699595,235,338,230,319,24,573
42.023685217,-87.69962728,0,1,1,0,0,1
42.025784,-87.684107,882,457,799,513,27,1339
42.03,-87.75,0,3,3,0,0,3
42.03,-87.73,1,2,3,0,0,3
42.03,-87.72,0,3,3,0,0,3
42.03,-87.71,53,41,94,0,0,94
42.03,-87.7,75,71,146,0,0,146
42.03,-87.69,130,35,165,0,0,165
42.03,-87.68,177,102,279,0,0,279
42.03,-87.67,49,30,79,0,0,79
42.032562,-87.679101,2125,1556,1884,1640,157,3681
42.0346318516159,-87.6991876959801,413,243,364,292,0,656
42.034632,-87.699188,0,39,0,0,39,39
42.034831166,-87.699165225,1,0,1,0,0,1
42.039742,-87.699413,526,449,556,392,27,975
42.04,-87.73,0,1,1,0,0,1
42.04,-87.72,1,4,5,0,0,5
42.04,-87.71,5,24,29,0,0,29
42.04,-87.7,64,38,102,0,0,102
42.04,-87.69,34,29,63,0,0,63
42.04,-87.68,350,170,520,0,0,520
42.04,-87.67,36,33,69,0,0,69
42.048059,-87.6834246666667,0,1,1,0,0,1
42.048188567,-87.68320787,0,1,1,0,0,1
42.048214,-87.683485,3814,2518,3035,3053,244,6332
42.04821527,-87.683526397,0,1,1,0,0,1
42.048308,-87.698224,716,451,606,536,25,1167
42.05,-87.75,0,3,3,0,0,3
42.05,-87.71,52,17,69,0,0,69
42.05,-87.7,22,49,71,0,0,71
42.05,-87.69,111,99,210,0,0,210
42.05,-87.68,701,675,1374,2,0,1376
42.05,-87.67,121,111,224,8,0,232
42.050491,-87.677821,2702,2809,1920,3282,309,5511
42.0504986666667,-87.677812,0,1,1,0,0,1
42.052939,-87.673447,2216,1467,1276,2240,167,3683
42.057044,-87.686554,752,624,578,740,58,1376
42.058239,-87.677432,3914,2840,2608,3931,215,6754
42.06,-87.76,1,0,1,0,0,1
42.06,-87.75,2,2,4,0,0,4
42.06,-87.74,1,0,1,0,0,1
42.06,-87.73,20,30,50,0,0,50
42.06,-87.72,12,18,30,0,0,30
42.06,-87.71,60,13,73,0,0,73
42.06,-87.7,62,58,120,0,0,120
42.06,-87.69,61,62,123,0,0,123
42.06,-87.68,361,328,688,1,0,689
42.06,-87.67,309,197,506,0,0,506
42.063598,-87.69873,823,625,771,615,62,1448
42.064313,-87.686152,874,496,549,753,68,1370
42.064854,-87.715297,369,356,299,391,35,725
42.07,-87.73,3,1,4,0,0,4
42.07,-87.72,1,6,7,0,0,7
42.07,-87.71,7,4,11,0,0,11
42.07,-87.7,21,30,51,0,0,51
42.07,-87.69,52,26,78,0,0,78
42.07,-87.68,24,29,53,0,0,53
42.08,-87.76,1,0,1,0,0,1
42.08,-87.71,1,4,5,0,0,5
42.08,-87.7,1,0,1,0,0,1
42.08,-87.69,1,12,13,0,0,13
42.08,-87.68,2,6,8,0,0,8
42.09,-87.87,0,1,1,0,0,1
42.11,-87.83,0,1,1,0,0,1
42.11,-87.74,0,1,1,0,0,1
42.11,-87.73,0,1,1,0,0,1
42.12,-87.74,1,0,1,0,0,1
42.19,-87.8,0,2,2,0,0,2
42.37,-87.83,1,0,1,0,0,1
